MOVE NAMES

aamaa kyanon アーマーキャノン (Armor Cannon) - Armor Cannon
aamu hammaa アームハンマー (Hammer Arm) - Arm Hammer
abareru あばれる (Thrash) - Thrash
afuro bureiku アフロブレイク (Head Charge) - Afro Break
aian heddo アイアンヘッド (Iron Head) - Iron Head
aian rooraa アイアンローラー (Steel Roller) - Iron Roller
aian teeru アイアンテール (Iron Tail) - Iron Tail
aisu booru アイスボール (Ice Ball) - Ice Ball
aisu hammaa アイスハンマー (Ice Hammer) - Ice Hammer
aisu supinaa アイススピナー (Ice Spinner) - Ice Spinner
aku no hadou あくのはどう (Dark Pulse) - Evil Pulse
akua bureiku アクアブレイク (Liquidation) - Aqua Break
akua jetto アクアジェット (Aqua Jet) - Aqua Jet
akua kattaa アクアカッター (Aqua Cutter) - Aqua Cutter
akua suteppu アクアステップ (Aqua Step) - Aqua Step
akua teeru アクアテール (Aqua Tail) - Aqua Tail
akubi あくび (Yawn) - Yawn
akuma no kissu あくまのキッス (Lovely Kiss) - # TBD #
akumu あくむ (Nightmare) - # TBD #
akurobatto アクロバット (Acrobatics) - Acrobatics
akuseru bureiku アクセルブレイク (Collision Course) - Accel Break
akuseru rokku アクセルロック (Accelerock) - Accel Rock
akuu setsudan あくうせつだん (Spacial Rend) - # TBD #
amaeru あまえる (Charm) - Fawn
amagoi あまごい (Rain Dance) - Rain Prayer
amai kaori あまいかおり (Sweet Scent) - Sweet Scent
ana o horu あなをほる (Dig) - Dig
ankaa shotto アンカーショット (Anchor Shot) - Anchor Shot
ankoku kyouda あんこくきょうだ (Wicked Blow) - Dark Blow
ankooru アンコール (Encore) - Encore
aoi honoo あおいほのお (Blue Flare) - # TBD #
arare あられ (Hail) - Hail
aroma misuto アロマミスト (Aromatic Mist) - # TBD #
aromaserapii アロマセラピー (Aromatherapy) - Aromatherapy
asa no hizashi あさのひざし (Morning Sun) - # TBD #
ashiddo bomu アシッドボム (Acid Spray) - Acid Bomb
ashisuto gia アシストギア (Gear Up) - # TBD #
ashisuto pawaa アシストパワー (Stored Power) - Assisted Power
asutoraru bitto アストラルビット (Astral Barrage) - # TBD #
ateminage あてみなげ (Vital Throw) - Parry Throw
awa あわ (Bubble) - Bubbles
ayashii hikari あやしいひかり (Confuse Ray) - Eerie Light
ayashii kaze あやしいかぜ (Ominous Wind) - # TBD #
baaku auto バークアウト (Snarl) - Bark Out
baburu kousen バブルこうせん (Bubble Beam) - Bubble Beam
bachibachi akuseru ばちばちアクセル (Zippy Zap) - # TBD #
bakajikara ばかぢから (Superpower) - # TBD #
bakuonpa ばくおんぱ (Boomburst) - Blast Waves
bakuretsu panchi ばくれつパンチ (Dynamic Punch) - Explosive Punch
baretto panchi バレットパンチ (Bullet Punch) - Bullet Punch
bariaa バリアー (Barrier) - Barrier
bariaa rasshu バリアーラッシュ (Psyshield Bash) - # TBD #
baton tacchi バトンタッチ (Baton Pass) - # TBD #
benomu shokku ベノムショック (Venoshock) - Venom Shock
benomu torappu ベノムトラップ (Venom Drench) - Venom Trap
bikkuri heddo ビックリヘッド (Mind Blown) - # TBD #
biribiri chikuchiku びりびりちくちく (Zing Zap) - Shocking Prickles
biribiri ereki びりびりエレキ (Buzzy Buzz) - # TBD #
birudo appu ビルドアップ (Bulk Up) - Build Up
bodi paaji ボディパージ (Autotomize) - Body Purge
bodi puresu ボディプレス (Body Press) - Body Press
boon rasshu ボーンラッシュ (Bone Rush) - Bone Rush
borutekkaa ボルテッカー (Volt Tackle) - Voltteccer
boruto chenji ボルトチェンジ (Volt Switch) - # TBD #
boufuu ぼうふう (Hurricane) - Hurricane
bougyo shirei ぼうぎょしれい (Defend Order) - Defend Order
buchikamashi ぶちかまし (Headlong Rush) - # TBD #
buibui bureiku ブイブイブレイク (Veevee Volley) - # TBD #
bukimi na juumon ぶきみなじゅもん (Eerie Spell) - # TBD #
bunmawasu ぶんまわす (Brutal Swing) - Brutal Swing
burasuto baan ブラストバーン (Blast Burn) - Blast Burn
bureibu baado ブレイブバード (Brave Bird) - Brave Bird
bureibu chaaji ブレイブチャージ (Take Heart) - # TBD #
bureiku kuroo ブレイククロー (Crush Claw) - Break Claw
bureizu kikku ブレイズキック (Blaze Kick) - Blaze Kick
burizaado ransu ブリザードランス (Glacial Lance) - # TBD #
burokkingu ブロッキング (Obstruct) - # TBD #
chaaji bimu チャージビーム (Charge Beam) - Charge Beam
chaamu boisu チャームボイス (Disarming Voice) - Charm Voice
chiisakunaru ちいさくなる (Minimize) - Shrink
chikara o suitoru ちからをすいとる (Strength Sap) - # TBD #
chikyuunage ちきゅうなげ (Seismic Toss) - Globe Throw
chou no mai ちょうのまい (Quiver Dance) - # TBD #
chouhatsu ちょうはつ (Taunt) - Taunt
chouonpa ちょうおんぱ (Supersonic) - Supersonic Waves
daaku hooru ダークホール (Dark Void) - Dark Hole
daburu atakku ダブルアタック (Double Hit) - Double Attack
daburu choppu ダブルチョップ (Double Chop) - Double Chop
daburu niidoru ダブルニードル (Twineedle) - Double Needle
daburu panzaa ダブルパンツァー (Double Iron Bash) - Double Panzer
daburu uingu ダブルウイング (Dual Wingbeat) - # TBD #
dai bakahatsu だいばくはつ (Explosion) - Explosion
daibingu ダイビング (Dive) - # TBD #
daichi no chikara だいちのちから (Earth Power) - Earth Power
daichi no hadou だいちのはどう (Terrain Pulse) - # TBD #
daifungeki だいふんげき (Raging Fury) - # TBD #
daimakkusu hou ダイマックスほう (Dynamax Cannon) - Daimax Cannon
daimonji だいもんじ (Fire Blast) - Great Blaze
daiya sutoomu ダイヤストーム (Diamond Storm) - # TBD #
dakuryuu だくりゅう (Muddy Water) - Muddy Water
damashiuchi だましうち (Feint Attack) - Sneak Attack
dame oshi ダメおし (Assurance) - # TBD #
dangai no tsurugi だんがいのつるぎ (Precipice Blades) - Precipice Blades
dasuto shuuto ダストシュート (Gunk Shot) - # TBD #
DD rariatto ＤＤラリアット (Darkest Lariat) - DD Lariat
deaigashira であいがしら (First Impression) - # TBD #
deka hammaa デカハンマー (Gigaton Hammer) - Giant Hammer
dekoreeshon デコレーション (Decorate) - Decoration
dengeki kushibashi でんげきくちばし (Bolt Beak) - # TBD #
dengeki ha でんげきは (Shock Wave) - Shock Wave
denji fuyuu でんじふゆう (Magnet Rise) - Electromagnetic Levitation [alt: EM Levitation]
denji ha でんじは (Thunder Wave) - Electromagnetic Wave [alt: EM Wave]
denji hou でんじほう (Zap Cannon) - Electromagnetic Cannon [alt: EM Cannon]
denki shokku でんきショック (Thunder Shock) - Electric Shock
denkou sekka でんこうせっか (Quick Attack) - Lightning Speed
denkou sougeki でんこうそうげき (Double Shock) - All-Out Lightning Attack
desu uingu デスウイング (Oblivion Wing) - Death Wing
dobadoba oora どばどばオーラ (Glitzy Glow) - # TBD #
dogezatsuki どげざつき (False Surrender) - Groveling Jab
dogezan ドゲザン (Kowtow Cleave) - Groveling Cleave
doku gasu どくガス (Poison Gas) - Poison Gas
doku no ito どくのいと (Toxic Thread) - # TBD #
doku no kona どくのこな (Poison Powder) - Poison Powder
dokubari どくばり (Poison Sting) - Poison Needle
dokubari senbon どくばりセンボン (Barb Barrage) - # TBD #
dokubishi どくびし (Toxic Spikes) - # TBD #
dokudoku どくどく (Toxic) - Toxic
dokudoku no kiba どくどくのキバ (Poison Fang) - # TBD #
dokudzuki どくづき (Poison Jab) - Poison Jab
doragon aroo ドラゴンアロー (Dragon Darts) - Dragon Arrow
doragon daibu ドラゴンダイブ (Dragon Rush) - Dragon Dive
doragon eeru ドラゴンエール (Dragon Cheer) - # TBD #
doragon enajii ドラゴンエナジー (Dragon Energy) - Dragon Energy
doragon hammaa ドラゴンハンマー (Dragon Hammer) - Dragon Hammer
doragon kuroo ドラゴンクロー (Dragon Claw) - Dragon Claw
doragon teeru ドラゴンテール (Dragon Tail) - Dragon Tail
doramu atakku ドラムアタック (Drum Beating) - Drum Attack
dorein kissu ドレインキッス (Draining Kiss) - Drain Kiss
dorein panchi ドレインパンチ (Drain Punch) - Drain Punch
doriru kuchibashi ドリルくちばし (Drill Peck) - Drill Beak
doriru rainaa ドリルライナー (Drill Run) - Drill Liner
doro asobi どろあそび (Mud Sport) - # TBD #
doro bakudan どろばくだん (Mud Bomb) - Mud Bomb
dorobou どろぼう (Thief) - Thief
dorokake どろかけ (Mud-Slap) - Mud Spray
dowasure ドわすれ (Amnesia) - # TBD #
ea kattaa エアカッター (Air Cutter) - Air Cutter
ea surasshu エアスラッシュ (Air Slash) - Air Slash
earoburasuto エアロブラスト (Aeroblast) - Aeroblast
edadzuki えだづき (Branch Poke) - Branch Jab
ekoo boisu エコーボイス (Echoed Voice) - # TBD #
enajii booru エナジーボール (Energy Ball) - Energy Ball
enmaku えんまく (Smokescreen) - Smokescreen
eragami エラがみ (Fishious Rend) - Jaw Bite
ereki booru エレキボール (Electro Ball) - Electric Ball
ereki fiirudo エレキフィールド (Electric Terrain) - Electric Field
ereki netto エレキネット (Electroweb) - Electric Net
erekutoro biimu エレクトロビーム (Electro Shot) - Electro Beam
fasuto gaado ファストガード (Quick Guard) - # TBD #
fearii rokku フェアリーロック (Fairy Lock) - Fairy Lock
feinto フェイント (Feint) - Feint
feitaru kuroo フェイタルクロー (Dire Claw) - Fatal Claw
fezaa dansu フェザーダンス (Feather Dance) - Feather Dance
foton geizaa フォトンゲイザー (Photon Geyser) - Photon Geyser
fruuru kanon フルールカノン (Fleur Cannon) - Fleur Cannon
fubuki ふぶき (Blizzard) - Blizzard
fuiuchi ふいうち (Sucker Punch) - Surprise Attack
fukitobashi ふきとばし (Whirlwind) - Blow Away
fukurodataki ふくろだたき (Beat Up) - # TBD #
fumitsuki ふみつけ (Stomp) - Stomp
fun'en ふんえん (Lava Plume) - # TBD #
fundo no kobushi ふんどのこぶし (Rage Fist) - Fist of Wrath
funjin ふんじん (Powder) - # TBD #
funka ふんか (Eruption) - # TBD #
furafura dansu フラフラダンス (Teeter Dance) - Wobbly Dance
furaingu puresu フライングプレス (Flying Press) - Flying Press
furasshu フラッシュ (Flash) - Flash
furawaa gaado フラワーガード (Flower Shield) - # TBD #
furawaa hiiru フラワーヒール (Floral Healing) - # TBD #
furea doraibu フレアドライブ (Flare Blitz) - Flare Drive
furea songu フレアソング (Torch Song) - # TBD #
furii fooru フリーフォール (Sky Drop) - Freefall
furiizu boruto フリーズボルト (Freeze Shock) - # TBD #
furiizu dorai フリーズドライ (Freeze-Dry) - Freeze-Dry
furui tateru ふるいたてる (Work Up) - Work Up
fushoku gasu ふしょくガス (Corrosive Gas) - # TBD #
fuuin ふういん (Imprison) - Seal
fuwafuwa fooru ふわふわフォール (Floaty Fall) - # TBD #
G no chikara Ｇのちから (Grav Apple) - G Power
gaado shea ガードシェア (Guard Split) - Guard Share
gaado suwappu ガードスワップ (Guard Swap) - Guard Swap
gaman がまん (Bide) - Bide
gamushara がむしゃら (Endeavor) - # TBD #
ganseki akkusu がんせきアックス (Rock Axe) - Rock Axe
ganseki fuuji がんせきふうじ (Rock Tomb) - Rock Seal
ganseki hou がんせきほう (Rock Wrecker) - # TBD #
garyou tensei ガリョウテンセイ (Dragon Ascent) - Draconic Masterstroke
gekirin げきりん (Outrage) - Reversed Scale
genshi no chikara げんしのちから (Ancient Power) - Primal Power
geppu ゲップ (Belch) - Belch
gia chenji ギアチェンジ (Shift Gear) - # TBD #
gia soosaa ギアソーサー (Gear Grind) - # TBD #
gifuto pasu ギフトパス (Bestow) - # TBD #
giga dorein ギガドレイン (Giga Drain) - Giga Drain
giga impakuto ギガインパクト (Giga Impact) - Giga Impact
gin'iro no kaze ぎんいろのかぜ (Silver Wind) - Silver Wind
goddo baado ゴッドバード (Sky Attack) - God Bird
goorudo rasshu ゴールドラッシュ (Make It Rain) - Gold Rush
goosuto daibu ゴーストダイブ (Phantom Force) - Ghost Dive
gurando foosu グランドフォース (Land's Wrath) - Ground Force
gurasu fiirudo グラスフィールド (Grassy Terrain) - Grass Field
gurasu mikusaa グラスミキサー (Leaf Tornado) - # TBD #
gurasu suraidaa グラススライダー (Grassy Glide) - # TBD #
habanero ekusu ハバネロエキス (Spicy Extract) - # TBD #
haado puranto ハードプラント (Frenzy Plany) - Hard Plant
haado puresu ハードプレス (Hard Press) - Hard Press
haado rooraa ハードローラー (Steamroller) - # TBD #
guroo panchi グロウパンチ (Power-Up Punch) - Grow Punch
haato sutampu ハートスタンプ (Heart Stamp) - Heart Stamp
haato suwappu ハートスワップ (Heart Swap) - Heart Swap
hadoudan はどうだん (Aura Sphere) - Guiding Wave Sphere
hagane no tsubasa はがねのつばさ (Steel Wing) - Steel Wing
haidoro kyanon ハイドロカノン (Hydro Cannon) - Hydro Cannon
haidoro pompu ハイドロポンプ (Hydro Pump) - Hydro Pump
haidoro suchiimu ハイドロスチーム (Hydro Steam) - Hydro Steam
haipaa boisu ハイパーボイス (Hyper Voice) - Hyper Voice
haipaa doriru ハイパードリル (Hyper Drill) - Hyper Drill
haisui no jin はいすいのじん (No Retreat) - # TBD #
haiyoru ichigeki はいよるいちげき (Skitter Smack) - # TBD #
hajikeru honoo はじけるほのお (Flame Burst) - Flame Burst
hakai kousen はかいこうせん (Hyper Beam) - Destroyer Beam
hakidasu はきだす (Spit Up) - # TBD #
hakkei はっけい (Force Palm) - Force Palm
hametsu no hikari はめつのひかり (Light of Ruin) - # TBD #
hametsu no negai はめつのねがい (Doom Desire) - # TBD #
hana fubuki はなふぶき (Petal Blizzard) - Petal Blizzard
hanabira no mai はなびらのまい (Petal Dance) - # TBD #
hane yasume はねやすめ (Roost) - Roost [subject to change]
haneru はねる (Splash) - Flop
happa kattaa はっぱカッター (Razor Leaf) - Leaf Cutter
happii taimu ハッピータイム (Happy Hour) - # TBD #
haradaiko はらだいこ (Belly Drum) - # TBD #
harouin ハロウィン (Trick-or-Treat) - Halloween
haru no arashi はるのあらし (Springtide Storm) - # TBD #
hasami girochin ハサミギロチン (Guillotine) - # TBD #
hasamu はさむ (Vise Grip) - # TBD #
hataki otosu はたきおとす (Knock Off) - Knock Off
hataku はたく (Pound) - Pound
hayate gaeshi はやてがえし (Upper Hand) - # TBD #
hebi nimari へびにらみ (Glare) - Snake Glare
hebii bombaa ヘビーボンバー (Heavy Slam) - Heavy Bomber
hedoro bakudan ヘドロばくだん (Sludge Bomb) - Sludge Bomb
hedoro kougeki ヘドロこうげき (Sludge) - Sludge Attack
hedoro ueebu ヘドロウェーブ (Sludge Wave) - Sludge Wave
henshin へんしん (Transform) - Transform
hiito sutampu ヒートスタンプ (Heat Crash) - # TBD #
hikari no kabe ひかりのかべ (Light Screen) - Light Screen
hiken: chienami ひけん・ちえなみ (Ceaseless Edge) - # TBD #
hikkaku ひっかく (Scratch) - Scratch
hikkuri kaesu ひっくりかえす (Topsy-Turvy) - # TBD #
himitsu no chikara ひみつのちから (Secret Power) - Secret Power
hinoko ひのこ (Ember) - Ember
hissatsu maeba ひっさつまえば (Hyper Fang) - # TBD #
hiya mizu ひやみず (Chilling Water) - # TBD #
hoeru ほえる (Roar) - Roar
hogoshoku ほごしょく (Camouflage) - # TBD #
hoiiru supin ホイールスピン (Spin Out) - Wheel Spin
hone buumeran ホネブーメラン (Bonemerang) - Bone Boomerang
hone konbou ホネこんぼう (Bone Club) - # TBD #
honoo no chikai ほのおのちかい (Fire Pledge) - Fire Pledge
honoo no kiba ほのおのキバ (Fire Fang) - Fire Fang
honoo no mai ほのおのまい (Fiery Dance) - # TBD #
honoo no muchi ほのおのムチ (Fire Lash) - # TBD #
honoo no panchi ほのおのパンチ (Fire Punch) - Fire Punch
honoo no uzu ほのおのうず (Fire Spin) - Fire Vortex
hoobaru ほおばる (Stuff Cheeks) - # TBD #
hoppe surisuri ほっぺすりすり (Nuzzle) - Cheek Rub
horobi no uta ほろびのうた (Perish Song) - # TBD #
hoshigaru ほしがる (Covet) - # TBD #
hotarubi ほたるび (Tail Glow) - # TBD #
houden ほうでん (Discharge) - Discharge
houfuku ほうふく (Comeuppance) - # TBD #
hyakki yakou ひゃっきやこう (Infernal Parade) - # TBD #
hyouzan oroshi ひょうざんおろし (Mountain Gale) - # TBD #
iai giri いあいぎり (Cut) - Slicing Draw
ibaru いばる (Swagger) - # TBD #
ibiki いびき (Snore) - # TBD #
icchou agari いっちょうあがり (Order Up) - # TBD #
ichamon いちゃもん (Torment) - # TBD #
ieki いえき (Gastro Acid) - Gastro Acid
ijigen hooru いじげんホール (Hyperspace Hole) - # TBD #
ijigen rasshu いじげんラッシュ (Hyperspace Fury) - # TBD #
ikari いかり (Rage) - Rage
ikari no maeba いかりのまえば (Super Fang) - Fangs of Rage
ikasama イカサマ (Foul Play) - # TBD #
ikiiki baburu いきいきバブル (Bouncy Bubble) - # TBD #
inazuma doraibu イナズマドライブ (Electro Drift) - # TBD #
infaito インファイト (Close Combat) - Infight
inishie no uta いにしえのうた (Relic Song) - # TBD #
inochi no shizuku いのちのしずく (Life Dew) - # TBD #
inochigake いのちがけ (Final Gambit) - # TBD #
itamiwake いたみわけ (Pain Split) - # TBD #
itetsuku shisen いてつくしせん (Freezing Glare) - # TBD #
ito o haku いとをはく (String Shot) - String Shot
iwa nadare いわなだれ (Rock Slide) - Rock Slide
iwa otoshi いわおとし (Rock Throw) - Rock Throw
iwakudaki いわくだき (Rock Smash) - # TBD #
iya na oto いやなおと (Screech) - # TBD #
iyashi no hadou いやしのはどう (Heal Pulse) - Healing Pulse
iyashi no negai いやしのねがい (Healing Wish) - Healing Wish
iyashi no suzu いやしのすず (Heal Bell) - Healing Bell
jadoku no kusari じゃどくのくさり (Malignant Chain) - # TBD #
jairo booru ジャイロボール (Gyro Ball) - Gyro Ball
janguru hiiru ジャングルヒール (Jungle Healing) - # TBD #
jaretsuku じゃれつく (Play Rough) - Play Rough
jetto panchi ジェットパンチ (Jet Punch) - Jet Punch
jiba sousa じばそうさ (Magnetic Flux) - # TBD #
jibaku じばく (Self-Destruct) - Self-Destruct
jidanda じだんだ (Stomping Tantrum) - Stomping Tantrum
jigoku guruma じごくぐるま (Submission) - # TBD #
jigokudzuki  じごくづき (Throat Chop) - Hell Thrust
jikoanji じこあんじ (Psych Up) - # TBD #
jikosaisei じこさいせい (Recover) - Self-Regenerate
jinarashi じならし (Bulldoze) - Ground Stomp
jinrai じんらい (Thunderclap) - # TBD #
jintsuuriki じんつうりき (Extrasensory) - Supernatural Power
jiokontorooru ジオコントロール (Geomancy) - # TBD #
jishin じしん (Earthquake) - # TBD #
jitabata じたばた (Flail) - # TBD #
jiware じわれ (Fissure) - Fissure
jouka じょうか (Purify) - # TBD #
juuden じゅうでん (Charge) - Charge
juuman bariki １０まんばりき (High Horsepower) - 100,000 Horsepower
juuman boruto １０まんぼると (Thunderbolt) - 100,000 Volts
juuryoku じゅうりょく (Gravity) - # TBD #
kaen booru かえんボール (Pyro Ball) - Pyro Ball
kaen guruma かえんぐるま (Flame Wheel) - Flame Wheel
kaen no mamori かえんのまもり (Burning Bulwark) - # TBD #
kaendan かえんだん (Searing Shot) - # TBD #
kaenhousha かえんほうしゃ (Flamethrower) - Flamethrower
kafun dango かふんだんご (Pollen Puff) - # TBD #
kage bunshin かげぶんしん (Double Team) - Shadow Clones
kagenui かげぬい (Spirit Shackle) - # TBD #
kageuchi かげうち (Shadow Sneak) - Shadow Strike
kagiwakeru かぎわける (Odor Sleuth) - # TBD #
kaidenpa かいでんぱ (Eerie Impulse) - # TBD #
kaifuku fuuji かいふくふうじ (Heal Block) - # TBD #
kaifuku shirei かいふくしれい (Heal Order) - Heal Order
kairiki かいりき (Strength) - Superstrength
kakato otoshi かかとおとし (Axe Kick) - # TBD #
kakubaru かくばる (Sharpen) - # TBD #
kamaitachi かまいたち (Razor Wind) - # TBD #
kamikudaku かみくだく (Crunch) - Crunch
kaminari かみなり (Thunder) - Thunder
kaminari arashi かみなりあらし (Wildbolt Storm) - # TBD #
kaminari no kiba かみなりのキバ (Thunder Fang) - Thunder Fang
kaminari panchi かみなりパンチ (Thunder Punch) - Thunder Punch
kamitsuku かみつく (Bite) - Bite
kanashibari かなしばり (Disable) - # TBD #
kara de hasamu からではさむ (Clamp) - # TBD #
kara ni komoru からにこもる (Withdraw) - # TBD #
kara o yaburu からをやぶる (Shell Smash) - # TBD #
karagenki からげんき (Facade) - False Bravado
karamitsuku からみつく (Constrict) - # TBD #
karate choppu からてチョップ (Karate Chop) - Karate Chop
kataki uchi かたきうち (Retaliate) - # TBD #
kataku naru かたくなる (Harden) - Harden
katasutorofi カタストロフィ (Ruination) - Catastrophe
kauntaa カウンター (Counter) - Counter
kawarawari かわらわり (Brick Break) - Brick Break
kazeokoshi かぜおこし (Gust) - Wind Gust
ketaguri けたぐり (Low Kick) - Kick Down
kiai dama きあいだま (Focus Blast) - Focus Blast
kiai dame きあいだめ (Focus Energy) - Focus Energy
kiai panchi きあいパンチ (Focus Punch) - Focus Punch
kimagu reezaa きまぐレーザー (Fickle Beam) - # TBD #
kingu shiirudo キングシールド (King's Shield) - # TBD #
kinoko no hoshi キノコのほうし (Spore) - Mushroom Spore
kinzokuon きんぞくおん (Metal Sound) - Metal Sound
kiraa supin キラースピン (Mortal Spin) - # TBD #
kirakira sutoomu きらきらストーム (Sparkly Swirl) - # TBD #
kiribarai きりばらい (Defog) - # TBD #
kirifuda きりふだ (Trump Card) - Trump Card
kirisaku きりさく (Slash) - Slash
kishi kaisei きしかいせい (Reversal) - Reversal
kitsuke きつけ (Smelling Salts) - # TBD #
koa panissha コアパニッシャー (Core Enforcer) - Core Punisher
kochikochi furosuto こちこちフロスト (Freezy Frost) - # TBD #
kogarashi arashi こがらしあらし (Bleakwind Storm) - # TBD #
kogoeru kaze こごえるかぜ (Icy Wind) - Icy Wind
kogoeru sekai こごえるせかい (Glaciate) - # TBD #
kokoro no me こころのめ (Mind Reader) - # TBD #
kometto panchi コメットパンチ (Meteor Mash) - Comet Punch
konayuki こなゆき (Powder Snow) - Powder Snow
kongen no hadou こんげんのはどう (Origin Pulse) - Origin Pulse
kono yubi tomare このゆびとまれ (Follow Me) - Follow My Finger
konoha このは (Leafage) - Leafage
koochingu コーチング (Coaching) - Coaching
koori no ibuki こおりのいぶき (Frost Breath) - Ice Breath
koori no kiba こおりのキバ (Ice Fang) - Ice Fang
koori no tsubute こおりのつぶて (Ice Shard) - Ice Shard
koorudo furea コールドフレア (Ice Burn) - # TBA #
kooto chenji コートチェンジ (Court Change) - Court Change
koraeru こらえる (Endure) - # TBD #
korogaru ころがる (Rollout) - Rollout
kosumo pawaa コスモパワー (Cosmic Power) - # TBD #
kotton gaado コットンガード (Cotton Guard) - Cotton Guard
kougeki shirei こうげきしれい (Attack Order) - Attack Order
kougousei こうごうせい (Synthesis) - Photosynthesis
kousoku idou こうそくいどう (Agility) - Agility
kousoku supin こうそくスピン (Rapid Spin) - Rapid Spin
kowai kao こわいかお (Scary Face) - Scary Face
kuchibashi kyanon くちばしキャノン (Beak Blast) - Beak Cannon
kuikku taan クイックターン (Flip Turn) - # TBD #
kumo no su クモのす (Spider Web) - # TBD #
kurabbu hammaa クラブハンマー (Crabhammer) - Crabhammer
kuraitsuku くらいつく (Jaw Lock) - # TBD #
kuria sumoggu クリアスモッグ (Clear Smog) - Clear Smog
kuroi kiri くろいきり (Haze) - # TBD #
kuroi manazashi くろいまなざし (Mean Look) - # TBD #
kuroroburasuto クロロブラスト (Chloroblast) - Chloroblast
kurosu choppu クロスチョップ (Cross Chop) - Cross Chop
kurosu fureimu クロスフレイム (Fusion Flare) - # TBD #
kurosu poizun クロスポイズン (Cross Poison) - Cross Poison
kurosu sandaa クロスサンダー (Fusion Bolt) - # TBD #
kusa musubi くさむすび (Grass Knot) - # TBD #
kusa no chikai くさのちかい (Grass Pledge) - Grass Pledge
kusawake くさわけ (Trailblaze) - # TBD #
kusabue くさぶえ (Grass Whistle) - # TBD #
kusuguru くすぐる (Tickle) - Tickle
kyojuudan きょじゅうだん (Behemoth Bash) - # TBD #
kyojuuzan きょじゅうざん (Behemoth Blade) - # TBD #
kyoken totsugeki きょけんとつげき (Glaive Rush) - Giant Sword Charge
kyuuketsu きゅうけつ (Leech Life) - # TBD #
maddo shotto マッドショット (Mud Shot) - Mud Shot
maguma sutoomu マグマストーム (Magma Storm) - Magma Storm
magunetto bomu マグネットボム (Magnet Bomb) - Magnet Bomb
magunichuudo マグニチュード (Magnitude) - Magnitude
mahha panchi マッハパンチ (Mach Punch) - Mach Punch
mahou no kona まほうのこな (Magic Powder) - Magic Powder
majikaru fureimu マジカルフレイム (Mystical Fire) - Magical Flame
majikaru riifu マジカルリーフ (Magical Leaf) - Magical Leaf
majikaru shain マジカルシャイン (Dazzling Gleam) - Magical Shine
majikku kooto マジックコート (Magic Coat) - Magic Coat
majikku ruumu マジックルーム (Magic Room) - Magic Room
makibishi まきびし (Spikes) - # TBD #
makitsuku まきつく (Wrap) - Wrap
mamoru まもる (Protect) - Protect
manekko まねっこ (Copycat) - Copycat
maruchi atakku マルチアタック (Multi-Attack) - Multi-Attack
marukunaru まるくなる (Defense Curl) - Curl Up
matowaritsuku まとわりつく (Infestation) - # TBD #
mawashigeri まわしげり (Rolling Kick) - # TBD #
mega dorein メガドレイン (Mega Drain) - Mega Drain
megahoon メガホーン (Megahorn) - Megahorn
megaton kikku メガトンキック (Mega Kick) - Megaton Kick
megaton panchi メガトンパンチ (Mega Punch) - Megaton Punch
meisou めいそう (Calm Mind) - Meditation
meramera baan めらめらバーン (Sizzly Slide) - # TBD #
meromero メロメロ (Attract) - Attract
metaru basutoo メタルバースト (Metal Burst) - Metal Burst
metaru kuroo メタルクロー (Metal Claw) - Metal Claw
meteo biimu メテオビーム (Meteor Beam) - Meteor Beam
meteo doraibu メテオドライブ (Sunsteel Strike) - Meteor Drive
mezamashi binta めざましビンタ (Wake-Up Slap) # TBD #
mezameru dansu めざめるダンス (Revelation Dance) - Awakening Dance
mezameru pawaa めざめるパワー (Hidden Power) - # TBD #
mi o kezuru みをけずる (Fillet Away) - # TBD #
michizure みちづれ (Destiny Bond) - Drag Along
midare dzuki みだれづき (Fury Attack) - Chaotic Jabs
midare hikkaki みだれひっかき (Fury Swipes) - Chaotic Scratches
migawari みがわり (Substitute) - Substitute
mikadzuki no inori みかづきのいのり (Lunar Blessing) - # TBD #
mikadzuki no mai みかづきのまい (Lunar Dance) - # TBD #
mikiri みきり (Detect) - Detect
mineuchi みねうち (False Swipe) - Blunt Edge Strike
miraa kooto ミラーコート (Mirror Coat) - Mirror Coat
miraa shotto ミラーショット (Mirror Shot) - Mirror Shot
miraa taipu ミラータイプ (Reflect Type) - Mirror Type
mirai yochi みらいよち (Future Sight) - # TBD #
mirakuru ai ミラクルアイ (Miracle Eye) - Miracle Eye
miruku nomi ミルクのみ (Milk Drink) - # TBD #
misairubari ミサイルばり (Pin Missile) - Needle Missile
misuto baasuto ミストバースト (Misty Explosion) - Mist Burst
misuto booru ミストボール (Mist Ball) - Mist Ball
misuto fiirudo ミストフィールド (Misty Terrain) - Mist Field
miwaku no boisu みわくのボイス (Alluring Voice) - # TBD #
miyaburu みやぶる (Foresight) - True Sight
mizu asobi みずあそび (Water Sport) - # TBD #
mizu deppou みずでっぽう (Water Gun) - Water Gun
mizu no chikai みずのちかい (Water Pledge) - Water Pledge
mizu no hadou みずのはどう (Water Pulse) - Water Pulse
mizu shuriken みずしゅりけん (Water Shuriken) - Water Shuriken
mizuame bomu みずあめボム (Syrup Bomb) - # TBD #
mizubitashi みずびたし (Soak) - # TBD #
moeagaru ikari もえあがるいかり (Fiery Wrath) - Blazing Rage
moetsukiru もえつきる (Burn Up) - Burn Up
monomane ものまね (Mimic) - # TBD #
mori no noroi もりののろい (Forest's Curse) - Forest's Curse
moroha no zutsuki もろはのずつき (Head Smash) - # TBD #
mugendai biimu ムゲンダイビーム (Eternabeam) - # TBD #
munen no tsurugi むねんのつるぎ (Bitter Blade) - Sword of Regrets
muunfoosu ムーンフォース (Moonblast) - Moonforce
mushi kui むしくい (Bug Bite) - Bug Bite
mushi no sazameki むしのさざめき (Bug Buzz) - # TBD #
mushi no teikou むしのていこう (Struggle Bug) - Bug Struggle
nagetsukeru なげつける (Fling) - # TBD #
naishobanashi ないしょばなし (Confide) - # TBD #
naito baasuto ナイトバースト (Night Daze) - Night Burst
naito heddo ナイトヘッド (Night Shade) - Night Head
nakama zukuri なかまづくり (Entrainment) - Befriend [subject to change]
nakayoku suru なかよくする (Play Nice) - # TBD #
nakigoe なきごえ (Growl) - Growl
namakeru なまける (Slack Off) - Slack Off
namidame なみだめ (Tearful Look) - # TBD #
naminori なみのり (Surf) - Surf
narikiri なりきり (Role Play) - # TBD #
nashikuzushi なしくずし (Chip Away) - # TBD #
nayami no tane なやみのタネ (Worry Seed) - # TBD #
ne o haru ねをはる (Ingrain) - Take Root
nebaneba netto ねばねばネット (Sticky Web) - Sticky Web
negaigoto ねがいごと (Wish) - Wish
negoto ねごと (Sleep Talk) - Sleep Talk
neko ni koban ネコにこばん (Pay Day) - # TBD #
neko no te ねこのて (Assist) - # TBD #
nekodamashi ねこだまし (Fake Out) - # TBD #
nemuri gona ねむりごな (Sleep Powder) - Sleep Powder
nemuru ねむる (Rest) - Sleep
nenriki ねんりき (Confusion) - Mind Power
neppuu ねっぷう (Heat Wave) - Heat Wave
neraiuchi ねらいうち (Snipe Shot) - Snipe Shot
nessa no arashi ねっさのあらし (Sandsear Storm) - # TBD #
nessa no daichi ねっさのだいち (Scorching Sands) - # TBD #
nettou ねっとう (Scald) - # TBD #
nezumizan ネズミざん (Population Bomb) - # TBD #
nidogeri にどげり (Double Kick) - Double Kick
nigiri tsubusu にぎりつぶす (Crush Grip) - # TBD #
nihonbare にほんばれ (Sunny Day) - Clear Skies
niidoru aamu ニードルアーム (Needle Arm) - Needle Arm
niidoru gaado ニードルガード (Spiky Shield) - Needle Guard
niramitsukeru にらみつける (Leer) - Scowl
nitoro chaaji ニトロチャージ (Flame Charge) - Nitro Charge
nomikomu のみこむ (Swallow) - # TBD #
noroi のろい (Curse) - Curse
noshikakari のしかかり (Body Slam) - Body Slam
ochakai おちゃかい (Teatime) - Tea Party
odateru おだてる (Flatter) - # TBD #
odorokasu おどろかす (Astonish) - # TBD #
ohakamairi おはかまいり (Last Respects) - # TBD #
oikaze おいかぜ (Tailwind) - Tailwind
oiuchi おいうち (Pursuit) - # TBD #
oiwai おいわい (Celebrate) - # TBD #
okatadzuke おかたづけ (Tidy Up) - # TBD #
okimiyage おきみやげ (Memento) - Parting Gift
okutank hou オクタンほう (Octazooka) - # TBD #
omajinai おまじない (Lucky Chant) - # TBD #
ongaeshi おんがえし (Return) - # TBD #
onibi おにび (Will-O-Wisp) - Will-O-Wisp
onnen おんねん (Grudge) - # TBD #
oobadoraibu オーバードライブ (Overdrive) - Overdrive
oobaahiito オーバーヒート (Overheat) - Overheat
oora guruma オーラぐるま (Aura Wheel) - # TBD #
oora uingu オーラウイング (Esper Wing) - # TBD #
oorora beeru オーロラベール (Aurora Veil) - Aurora Veil
oorora biimu オーロラビーム (Aurora Beam) - Aurora Beam
osaki ni douzou おさきにどうぞ (After You) - # TBD #
oshaberi おしゃべり (Chatter) - # TBD #
oshioki おしおき (Punishment) - # TBD #
otakebi おたけび (Noble Roar) - War Cry
oufuku binta おうふくビンタ (Double Slap) - Round-Trip Slap
oumu gaeshi オウムがえし (Mirror Move) - Parrot Mimicry [subject to change]
parabora chaaji パラボラチャージ (Parabolic Charge) - # TBD #
pawaa jemu パワージェム (Power Gem) - Power Gem
pawaa shea パワーシェア (Power Split) - # TBD #
pawaa shifuto パワーシフト (Power Shift) - Power Shift
pawaa suwappu パワースワップ (Power Swap) - Power Swap
pawaa torikku パワートリック (Power Trick) - Power Trick
pawaa uippu パワーウィップ (Power Whip) - Power Whip
pikapika sandaa ピカピカサンダー (Pika Papow) - # TBD #
piyopiyo panchi ピヨピヨパンチ (Dizzy Punch) - Chirp-Chirp Punch
poizun teeru ポイズンテール (Poison Tail) - Poison Tail
porutaagaisuto ポルターガイスト (Poltergeist) - Poltergeist
purazuma fisuto プラズマフィスト (Plasma Fists) - Plasma Fists [subject to change]
purazuma shawaa プラズマシャワー (Ion Deluge) - Plasma Shower
purezento プレゼント (Present) - Present
purizumu reezaa プリズムレーザー (Prismatic Laser) - Prism Laser
raigeki らいげき (Bolt Strike) - # TBD #
raijingu boruto ライジングボルト (Rising Voltage) - Rising Bolt
raimai geri らいめいげり (Thunderous Kick) - # TBD #
rasutaa kanon ラスターカノン (Flash Cannon) - Luster Cannon
rasutaa paaji ラスターパージ (Luster Purge) - Luster Purge
reijingu buru レイジングブル (Raging Bull) - Raging Bull
reitou biimu れいとうビーム (Ice Beam) - Ice Beam
reitou panchii れいとうパンチ (Ice Punch) - Ice Punch
rengoku れんごく (Inferno) - Purgatory
renzoku giri れんぞくぎり (Fury Cutter) - Consecutive Cut
renzoku panchi れんぞくパンチ (Comet Punch) - Consecutive Punch [subject to change]
ribenji リベンジ (Revenge) - Revenge
rifurektaa リフレクター (Reflect) - Reflector
rifuresshu リフレッシュ (Refresh) - Refresh
riifu bureido リーフブレード (Leaf Blade) - Leaf Blade
riifu sutoomu リーフストーム (Leaf Storm) - Leaf Storm
ringo san りんごさん (Apple Acid) - # TBD #
rinshou りんしょう (Round) - Round
risaikuru リサイクル (Recycle) - Recycle
rokketo zutsuki ロケットずつき (Skull Bash) - Rocket Headbutt
rokku burasuto ロックブラスト (Rock Blast) - Rock Blast
rokku katto ロックカット (Rock Polish) - # TBD #
rokku kuraimu ロッククライム (Rock Climb) - Rock Climb
rokku on ロックオン (Lock-On) - Lock-On
rou kikku ローキック (Low Sweep) - Low Kick
rumina korijon ルミナコリジョン (Lumina Crash) - Lumina Collision
ryuu no hadou りゅうのはどう (Dragon Pulse) - Dragon Pulse
ryuu no ibuki りゅうのいぶき (Dragon Breath) - Dragon Breath
ryuu no ikari りゅうのいかり (Dragon Rage) - Dragon Rage
ryuu no mai りゅうのまい (Dragon Dance) - Dragon Dance
ryuuseigun りゅうせいぐん (Draco Meteor) - Dragon Meteor Shower
sabaki no tsubute さばきのつぶて (Judgment) - # TBD #
saido chenji サイドチェンジ (Ally Switch) - # TBD #
saihai さいはい (Instruct) - # TBD #
saike kousen サイケこうせん (Psybeam) - Psybeam
saiki no inori さいきのいのり (Revival Blessing) - # TBD #
saiko bureido サイコブレイド (Psyblade) - # TBD #
saiko bureiku サイコブレイク (Psystrike) - # TBD #
saiko buusuto サイコブースト (Psycho Boost) - Psycho Boost
saiko fangu サイコファング (Psychic Fangs) - # TBD #
saiko fiirudo サイコフィールド (Psychic Terrain) - Psycho Field
saiko kattaa サイコカッター (Psycho Cut) - Psycho Cutter
saiko noizu サイコノイズ (Psychic Noise) - # TBD #
saiko shifuto サイコシフト (Psycho Shift) - Psycho Shift
saiko shokku サイコショック (Psyshock) - Psycho Shock
saiko ueebu サイコウェーブ (Psywave) - # TBD #
saikokineshisu サイコキネシス (Psychic) - Psychokinesis
saimin jutsu さいみんじゅつ (Hypnosis) - Hypnosis
saki okuri さきおくり (Quash) - Postpone [subject to change]
sakidori さきどり (Me First) - # TBD #
samui gyagu さむいギャグ (Chilly Reception) - # TBD #
sanbon no ya ３ぼんのや (Triple Arrows) - # TBD #
sandaa daibu サンダーダイブ (Supercell Slam) - Thunder Dive
sandaa purizun サンダープリズン (Thunder Cage) - Thunder Prison
sashiosae さしおさえ (Embargo) - # TBD #
sauzando aroo サウザンアロー (Thousand Arrows) - Thousand Arrows
sauzando ueebu サウザンウェーブ (Thousand Waves) - Thousand Waves
sawagu さわぐ (Uproar) - Uproar
seichou せいちょう (Growth) - Growth
seinaru honoo せいなるほのお (Sacred Fire) - Sacred Fire
seinaru tsurugi せいなるつるぎ (Sacred Sword) - Sacred Sword
shadoo boon シャドーボーン (Shadow Bone) - Shadow Bone
shadoo booru シャドーボール (Shadow Ball) - Shadow Ball
shadoo daibu シャドーダイブ (Shadow Force) - Shadow Dive
shadoo kuroo シャドークロー (Shadow Claw) - Shadow Claw
shadoo panchi シャドーパンチ (Shadow Punch) - Shadow Punch
shadoo rei シャドーレイ (Moongeist Beam) - Shadow Ray
shadoo suchiiru シャドースチール (Spectral Thief) - Shadow Steal
shakashaka hou シャカシャカほう (Matcha Gotcha) - Whisk-Whisk Cannon
sheru aamuzu シェルアームズ (Shell Side Arm) - # TBD #
sheru bureedo シェルブレード (Razor Shell) - Shell Blade
shibiregona しびれごな (Stun Spore) - Stun Spore
shiboritoru しぼりとる (Wring Out) - # TBD #
shiido furea シードフレア (Seed Flare) - Seed Flare
shigunaru biimu シグナルビーム (Signal Beam) - Signal Beam
shimetsukeru しめつける (Bind) - Bind
shinen no zutsuki しねんのずつき (Zen Headbutt) - Mind Headbutt
shinkuronoizu シンクロノイズ (Synchronoise) - # TBD #
shinkuu ha しんくうは (Vacuum Wave) - Vacuum Wave
shinpi no chikara しんぴのちから (Mystical Power) - # TBD #
shinpi no mamori しんぴのまもり (Safeguard) - # TBD #
shinpi no tsurugi しんぴのつるぎ (Secret Sword) - # TBD #
shinpuru biimu シンプルビーム (Simple Beam) - Simple Beam
shinsoku しんそく (Extreme Speed) - Divine Speed
shiodzuke しおづけ (Salt Cure) - Salt Pickling
shiofuki しおふき (Water Spout) - # TBD #
shiomizu しおみず (Brine) - # TBD #
shippegaeshi しっぺがえし (Payback) - # TBD #
shippo kuri しっぽきり (Shed Tail) - # TBD #
shippo o furu しっぽをふる (Tail Whip) - # TBD #
shiroi kiri しろいきり (Mist) - White Mist
shita de nameru したでなめる (Lick) - # TBD #
shitto no honoo しっとのほのお (Burning Jealousy) - # TBD #
shizaa kurosu シザークロス (X-Scissor) - Scissor Cross
shizen no chikara しぜんのちから (Nature Power) - # TBD #
shizen no ikari しぜんのいかり (Nature's Madness) - Nature's Wrath [subject to change]
shizen no megumi しぜんのめぐみ (Natural Gift) - # TBD #
shoori no mai しょうりのまい (Victory Dance) - # TBD #
sonikku buumu ソニックブーム (Sonic Boom) - Sonic Boom
sooraa biimu ソーラービーム (Solar Beam) - Solar Beam
sooraa bureedo ソーラーブレード (Solar Blade) - Solar Blade
sora o tobu そらをとぶ (Fly) - Fly
souden そうでん (Electrify) - # TBD #
sourubiito ソウルビート (Clangorous Soul) - Soulbeat
souru kurasshu ソウルクラッシュ (Spirit Break) - Soul Crush
suchiimu baasuto スチームバースト (Steam Eruption) - # TBD #
suiipu binta スイープビンタ (Tail Slap) - # TBD #
suiryuu renda すいりゅうれんだ (Surging Strikes) - Pouring Strikes
suitoru すいとる (Absorb) - # TBD #
sukai appaa スカイアッパー (Sky Uppercut) - # TBD #
sukecchi スケッチ (Sketch) - Sketch
sukeiru noizu スケイルノイズ (Scale Noise) - Scale Noise
sukeiru shotto スケイルショット (Scale Shot) - Scale Shot
sukiru suwappu スキルスワップ (Skill Swap) - Skill Swap
sukusuku bombaa すくすくボンバー (Sappy Seed) - # TBD #
sumaato hoon スマートホーン (Smart Strike) - Smart Horn
sumoggu スモッグ (Smog) - # TBD #
suna arashi すなあらし (Sandstorm) - Sandstorm
suna jigoku すなじごく (Sand Tomb) - Sand Hell
sunaatsume すなあつめ (Shore Up) - # TBD #
sunakake すなかけ (Sand Attack) - Sand Attack [subject to change]
supaaku スパーク (Spark) - Spark
supiido sutaa スピードスター (Swift) - Speed Star
supiido suwappu スピードスワップ (Speed Swap) - Speed Swap
supottoraito スポットライト (Spotlight) - Spotlight
supuun mage スプーンまげ (Kinesis) - # TBD #
sureddo torappu スレッドトラップ (Silk Trap) - # TBD #
surikae すりかえ (Switcheroo) - # TBD #
sutaa asaruto スターアサルト (Meteor Assault) - Star Assault
sute zerifu すてゼリフ (Parting Shot) - # TBD #
sutemi takkuru すてみタックル (Double-Edge) - Desperate Tackle
suterusu rokku ステルスロック (Stealth Rock) - Stealth Rock
sutoon ejji ストーンエッジ (Stone Edge) - Stone Edge
taaru shotto タールショット (Tar Shot) - Tar Shot
tagayasu たがやす (Rototiller) - # TBD #
taiatari たいあたり (Tackle) - Tackle
taki nobori たきのぼり (Waterfall) - # TBD #
takion kattaa タキオンカッター (Tachyon Cutter) - # TBD #
takogatame たこがため (Octolock) - Octolock
takuwaeru たくわえる (Stockpile) - Stockpile
tamago bakudan タマゴばくだん (Egg Bomb) - Egg Bomb
tamago umi タマゴうみ (Soft-Boiled) - # TBD #
tamanage たまなげ (Barrage) - # TBD #
tane bakudan タネばくだん (Seed Bomb) - Seed Bomb
tane mashingan タネマシンガン (Bullet Seed) - Seed Machine Gun
tatakitsukeru たたきつける (Slam) - Slam
tatamigaeshi たたみがえし (Mat Block) - # TBD #
tatari me たたりめ (Hex) - Evil Eye
tatekomoru たてこもる (Shelter) - # TBD #
tatsumaki たつまき (Twister) - Twister
te o tsunagu てをつなぐ (Hold Hands) - # TBD #
tedasuke てだすけ (Helping Hand) - Helping Hand
tekagen てかげん (Hold Back) - # TBD #
tekuno basutaa テクノバスター (Techno Blast) - # TBD #
tekusuchaa テクスチャー (Conversion) - Texture
tekusuchaa 2 テクスチャー２ (Conversion 2) - Texture 2
tenshi no kissu てんしのキッス (Sweet Kiss) - # TBD #
teppeki てっぺき (Iron Defense) - Iron Defense
tera baasuto テラバースト (Tera Blast) - Tera Burst
tera kurasutaa テラクラスター (Tera Starstorm) - Tera Cluster
terekineshisu テレキネシス (Telekinesis) - Telekinesis
terepooto テレポート (Teleport) - Teleport
tettei kousen てっていこうせん (Steel Beam) - Steely Resolve
tobigeri とびげり (Jump Kick) - # TBD #
tobihaneru とびはねる (Bounce) - # TBD #
tobihizageri とびひざげり (High Jump Kick) - High Jump Kick [subject to change]
tobikakaru とびかかる (Lunge) - Lunge
tobitsuku とびつく (Pounce) - Pounce
todomebari とどめばり (Fell Stinger) - # TBD #
toge kyanon とげキャノン (Spike Cannon) - Spike Cannon [subject to change]
togisumasu とぎすます (Laser Focus) - # TBD #
toguro o maku とぐろをまく (Coil) - # TBD #
tokeru とける (Acid Armor) - # TBD #
toki no houkou ときのほうこう (Roar of Time) - # TBD #
tomoenage ともえなげ (Circle Throw) - Circle Throw
tonbo gaeri とんぼがえり (U-Turn) - Dragonfly Turnaround
tooboe とおぼえ (Howl) - # TBD #
toochika トーチカ (Baneful Bunker) - # TBD #
toosenbou とおせんぼう (Block) - # TBD #
torabasami トラバサミ (Snap Trap) - # TBD #
torai atakku トライアタック (Tri Attack) - Tri Attack
torappu sheru トラップシェル (Shell Trap) - Trap Shell
torikku トリック (Trick) - Trick
torikku furawaa トリックフラワー (Flower Trick) - Trick Flower
torikku gaado トリックガード (Crafty Shield) - # TBD #
torikku ruumu トリックルーム (Trick Room) - Trick Room
toripuru akuseru トリプルアクセル (Triple Axel) - Triple Axel
toripuru daibu トリプルダイブ (Triple Dive) - Triple Dive
toriporu kikku トリプルキック (Triple Kick) - Triple Kick
toropikaru kikku トロピカルキック (Trop Kick) - Tropical Kick
tosshin とっしん (Take Down) - Take Down
totteoki とっておき (Last Resort) - # TBD #
tsubame gaeshi つばめがえし (Aerial Ace) - Turning Swallow Strike
tsubasa de utsu つばさでうつ (Wing Attack) - Wing Attack
tsubo o tsuku つぼをつく (Accupressure) - # TBD #
tsuburana hitomi つぶらなひとみ (Baby-Doll Eyes) - # TBD #
tsuibamu ついばむ (Pluck) - # TBD #
tsuin biimu ツインビーム (Twin Beam) - # TBD #
tsujigiri つじぎり (Night Slash) - Crossroad Kill
tsukeagaru つけあがる (Power Trip) - # TBD #
tsuki no hikari つきのひかり (Moonlight) - Moonlight
tsumetogi つめとぎ (Hone Claws) - Hone Claws
tsuno de tsuku つのでつく (Horn Attack) - Horn Attack
tsuno doriru つのドリル (Horn Drill) - Horn Drill
tsuppari つっぱり (Arm Thrust) - Arm Thrust
tsurara bari つららばり (Icicle Spear) - Icicle Spears
tsurara otoshi つららおとし (Icicle Crash) - Icicle Drop
tsuru no muchi つるのムチ (Vine Whip) - Vine Whip
tsurugi no mai つるぎのまい (Swords Dance) - Swords Dance
tsuta konbou ツタこんぼう (Ivy Cudgel) - # TBD #
tsutsuku つつく (Peck) - Peck
uchiotosu うちおとす (Smack Down) - # TBD #
uddo hammaa ウッドハンマー (Wood Hammer) - Wood Hammer
uddo hoon ウッドホーン (Horn Leech) - Wood Horn
ueebu takkuru ウェーブタックル (Wave Crash) - Wave Tackle
uezaa booru ウェザーボール (Weather Ball) - Weather Ball
uppun barashi うっぷんばらし (Lash Out) - # TBD #
urami うらみ (Spite) - # TBD #
urami tsurami うらみつらみ (Bitter Malice) - # TBD #
uso naki うそなき (Fake Tears) - Fake Tears
utakata no aria うたかた (Sparkling Aria) - # TBD #
utau うたう (Sing) - Sing
utsushie うつしえ (Doodle) - # TBD #
uzushio うずしお (Whirlpool) - Whirlpool
V jenereeto Ｖジェネレート (V-create) - # TBD #
waido bureikaa ワイドブレイカー (Breaking Swipe) - Wide Breaker
waido foosu ワイドフォース (Expanding Force) - Wide Force
waido gaado ワイドガード (Wide Guard) - Wide Guard
wairudo boruto ワイルドボルト (Wild Charge) - Wild Bolt
wandaa ruumu ワンダールーム (Wonder Room) - Wonder Room
wandaa suchiimu ワンダースチーム (Strange Steam) - Wonder Steam
waru dakumi わるだくみ (Nasty Plot) - Nasty Plot
waruagaki わるあがき (Struggle) - Struggle in Vain [subject to change]
waruwaru zoon わるわるゾーン (Baddy Bad) - # TBD #
wata houshi わたほうし (Cotton Spore) - Cotton Spore
yadorigi no tane やどりぎのタネ (Leech Seed) - # TBD #
yakeppachi やけっぱち (Temper Flare) - # TBD #
yaki tsukusu やきつくす (Incinerate) - # TBD #
yama arashi やまあらし (Storm Throw) - # TBD #
yatsuatari やつあたり (Frustration) - # TBD #
yoga no poozu ヨガのポーズ (Meditate) - Yoga Pose
yokodori よこどり (Snatch) - # TBD #
youkaieki ようかいえき (Acid) - Acid
yousei no kaze ようせいのかぜ (Fairy Wind) - Fairy Wind
yubi o furu ゆびをふる (Metronome) - # TBD #
yuki geshiki ゆきげしき (Snowscape) - # TBD #
yuki nadare ゆきなだれ (Avalanche) - # TBD #
yume kui ゆめくい (Dream Eater) - Dream Eater
yuuwaku ゆうわく (Captivate) - # TBD #
zabuzabu saafu ざぶざぶサーフ (Splishy Splash) - # TBD #
zettai reido ぜったいれいど (Sheer Cold) - Absolute Zero
zutsuki ずつき (Headbutt) - Headbutt



Z-MOVE NAMES

arutimetto doragon baan アルティメット ドラゴン バーン (Devastating Drake) - Ultimate Dragon Burn
ashiddo poizun deriito アシッドポイズンデリート (Acid Downpour) - Acid Poison Delete
burakku hooru ikuripusu ブラックホールイクリプス (Black Hole Eclipse) - Black Hole Eclipse
bureijingu soorubiito ブレイジングソウルビート (Clangorous Soulblaze) - Blazing Soulbeat
buruumu shain ekusutora ブルームシャインエクストラ (Bloom Doom) - Bloom Shine Extra
chouzetsu rasen rengeki 超絶螺旋連撃 (Corkscrew Crash) - Super Spiral Combo
dainamiku furu fureimu ダイナミックフルフレイム (Inferno Overdrive) - Dynamic Full Flame
fainaru daibu kurasshu ファイナルダイブクラッシュ (Supersonic Skystrike) - Final Dive Crash
gaadian de aroora ガーディアン・デ・アローラ (Guardian of Alola) - Guardian de Alola
haipaa daaku kurasshaa ハイパーダーククラッシャー (Malicious Moonsault) - Hyper Dark Crusher
hissatsu no pikachoot ひっさつのピカチュート (Catastropika) - Fatal Pikachoot
honki o dasu kougeki ほんきをだすこうげき (Pulverizing Pancake) - Actually Serious Attack
makishimaru saibureikaa マキシマムサイブレイカー (Shattered Psyche) - Maximum Psybreaker
mugen an'ya e no izanai 無限暗夜への誘い (Never-Ending Nightmare) - Call of the Endless Night
muunraito burasutaa ムーンライトブラスター (Menacing Moonraze Maelstrom) - Moonlight Blaster
nain eboru buusuto ナインエボルブースト (Extreme Evoboost) - Nine Evol Boost
poka-boka furendo taimu ぽかぼかフレンドタイム (Let's Snuggle Forever) - Snuggly Friend Time
raburii sutaa impakuto ラブリースターインパクト (Twinkle Tackle) - Lovely Star Impact
raijingu rando oubaa ライジングランドオーバー (Tectonic Rage) - Rising Land Over
raitoningu saafu raido ライトニングサーフライド (Stoked Sparksurfer) - Lightning Surf Ride
rajiaru ejjisutoomu ラジアルエッジストーム (Splintered Stormshards) - Radial Edgestorm
reijingu jiofuriizu レイジングジオフリーズ (Subzero Slammer) - Raging Geofreeze
sanshain sumasshaa サンシャインスマッシャー (Searing Sunraze Smash) - Sunshine Smasher
senman boruto １０００まんボルト (10,000,000 Volt Thunderbolt) - 10,000,000 Volts
shadou aroozu sutoraiku シャドーアローズストライク (Sinister Arrow Raid) - Shadow Arrows Strike
shichisei dakkontai 七星奪魂腿 (Soul-Stealing 7-Star Strike) - # TBD #
supaa akua toruneedo スーパーアクアトルネード (Hydro Vortex) - Super Aqua Tornado
supaakingu gigaboruto スパーキングギガボルト (Gigavolt Havoc) - Sparking Gigavolt
ten kogasu metsubou no hikari 天焦がす滅亡の光 (Light That Burns the Sky) - # TBD #
urutora dasshu atakku ウルトラダッシュアタック (Breakneck Blitz) - Ultra Dash Attack
waaruzu endo fooru ワールズエンドフォール (Continental Crush) - World's End Fall
wadatsumi no shinfonia わだつみのシンフォニア (Oceanic Operetta) - Sea God's Symphonia
zenryoku musou gekiretsu ken 全力無双激烈拳 (All-Out Pummeling) - Full Power Peerless Fists of Fury
zettai hoshoku kaitenzan 全力無双激烈拳 (Savage Spin-Out) - Absolute Predatory Spin-Out



DAIMAX MOVE NAMES

dai aasu ダイアース (Max Quake) - Dai Earth
dai aisu ダイアイス (Max Hailstorm) - Dai Ice
dai ashiddo ダイアシッド (Max Ooze) - Dai Acid
dai atakku ダイアタック (Max Strike) - Dai Attack
dai baan ダイバーン (Max Flare) - Dai Burn
dai daaku ダイアーク (Max Darkness) - Dai Dark
dai doraguun ダイドラグーン (Max Wyrmwind) - Dai Dragoon
dai fearii ダイフェアリー (Max Starfall) - Dai Fairy
dai horoo ダイホロウ (Max Phantasm) - Dai Hollow
dai jetto ダイジェット (Max Airstream) - Dai Jet
dai nakkuru ダイナックル (Max Knuckle) - Dai Knuckle
dai rokku ダイロック (Max Rockfall) - Dai Rock
dai saiko ダイサイコ (Max Mindstorm) - Dai Psycho
dai sandaa ダイサンダー (Max Lightning) - Dai Thunder
dai sougen ダイソウゲン (Max Overgrowth) - Dai Grassland
dai suchiru ダイスチル (Max Steelspike) - Dai Steel
dai sutoriimu ダイストリーム (Max Geyser) - Dai Stream
dai uooru ダイウォール (Max Guard) - Dai Wall
dai waamu ダイワーム (Max Flutterby) - Dai Worm
kyodai banrai キョダイバンライ (G-Max Volt Crash) - Kyodai Heavy Thunder
kyodai bentatsu キョダイベンタツ (G-Max Vine Lash) - # TBD #
kyodai dan'en キョダイダンエン (G-Max Finale) - Kyodai Finale
kyodai fuugeki キョダイフウゲキ (G-Max Wind Rage) - # TBD #
kyodai funseki キョダイフンセキ (G-Max Volcalith) - # TBD #
kyodai ganjin キョダイガンジン (G-Max Stonesurge) - # TBD #
kyodai gen'ei キョダイゲンエイ (G-Max Terror) - Kyodai Phantom
kyodai gensui キョダイゲンスイ (G-Max Depletion) - Kyodai Decay
kyodai gokuen キョダイゴクエン (G-Max Wildfire) - Kyodai Hellfire
kyodai hooyoo キョダイホーヨー (G-Max Cuddle) - # TBD #
kyodai hougeki キョダイホウゲキ (G-Max Cannonade) - # TBD #
kyodai houmatsu キョダイホウマツ (G-Max Foam Burst) - # TBD #
kyodai hyakka キョダイヒャッカ (G-Max Centiferno) - # TBD #
kyodai ichigeki キョダイイチゲキ (G-Max One Blow) - # TBD #
kyodai kakyuu キョダイカキュウ (G-Max Fireball) - # TBD #
kyodai kanden キョダイカンデン (G-Max Stun Shock) - # TBD #
kyodai kanro キョダイカンロ (G-Max Sweetness) - # TBD #
kyodai koban キョダイコバン (G-Max Gold Rush) - Kyodai Charm
kyodai koujin キョダイコウジン (G-Max Steelsurge) - # TBD #
kyodai koranda キョダイコランダ (G-Max Drum Solo) - Kyodai Drum Bash
kyodai kowaku キョダイコワク (G-Max Befuddle) - # TBD #
kyodai rengeki キョダイレンゲキ (G-Max Rapid Flow) - # TBD #
kyodai saisei キョダイサイセイ (G-Max Replenish) - # TBD #
kyodai sajin キョダイサジン (G-Max Sandblast) - # TBD #
kyodai sangeki キョダイサンゲキ (G-Max Tartness) - # TBD #
kyodai senritsu キョダイセンリツ (G-Max Resonance) - # TBD #
kyodai shingeki キョダイシンゲキ (G-Max Chi Strike) - Kyodai Focus Blow
kyodai shuuki キョダイシュウキ (G-Max Malodor) - Kyodai Stench
kyodai sogeki キョダイソゲキ (G-Max Hydrosnipe) - # TBD #
kyodai suima キョダイスイマ (G-Max Snooze) - Kyodai Snooze
kyodai tenbatsu キョダイテンバツ (G-Max Smite) - # TBD #
kyodai tendou キョダイテンドウ (G-Max Gravitas) - # TBD #
kyodai yuugeki キョダイユウゲキ (G-Max Meltdown) - # TBD #



ABILITY NAMES

aisu bodii アイスボディ (Ice Body) - Ice Body
aisu feisu アイスフェイス (Ice Face) - Ice Face
akushuu あくしゅう (Stench) - # TBD #
ama no jaku あまのじゃく (Contrary) - # TBD #
ame ukezara あめうけざら (Rain Dish) - # TBD #
amefurashi あめふらし (Drizzle) - # TBD #
anaraizu アナライズ (Analytic) - # TBD #
AR shisutemu ＡＲシステム (RKS System) - AR System
arijigoku ありじごく (Arena Trap) - # TBD #
aroma beeru アロマベール (Aroma Veil) - Aroma Veil
atodashi あとだし (Stall) - # TBD #
atsui shibou あついしぼう (Thick Fat) - Thick Fat
bake no kawa ばけのかわ (Disguise) - # TBD #
banken ばんけん (Guard Dog) - # TBD #
baria furii バリアフリー (Screen Cleaner) - # TBD #
batoru suicchi バトルスイッチ (Stance Change) - # TBD #
batterii バッテリー (Battery) - Battery
bibiddo bodi ビビッドボディ (Dazzling) - # TBD #
bibiri びびり (Rattled) - # TBD #
biisuto buusuto ビーストブースト (Beast Boost) - Beast Boost
binjou びんじょう (Opportunist) - # TBD #
bouon ぼうおん (Soundproof) - # TBD #
boudan ぼうだん (Bulletproof) - # TBD #
boujin ぼうじん (Overcoat) - # TBD #
bukiyou ぶきよう (Klutz) - # TBD #
burein foosu ブレインフォース (Neuroforce) - # TBD #
chidori ashi ちどりあし (Tangled Feet) - # TBD #
chikara mochi ちからもち (Huge Power) - # TBD #
chikara zuku ちからずく (Sheer Force) - # TBD #
chikuden ちくでん (Volt Absorb) - # TBD #
chosui ちょすい (Water Absorb) - # TBD #
daaku oora ダークオーラ (Dark Aura) - Dark Aura
dappai だっぴ (Shed Skin) - # TBD #
daruma moodo ダルマモード (Zen Mode) - Daruma Mode
daunroodo ダウンロード (Download) - Download
denki enjin でんきエンジン (Motor Drive) - Electric Engine
denki ni kaeru でんきにかえる (Electromorphosis) - Making Electribbity
deruta sutoriimu デルタストリーム (Delta Stream) - Delta Stream
doku bousou どくぼうそう (Toxic Boost) - # TBD #
doku kugutsu どくくぐつ (Poison Puppeteer) - # TBD #
doku no kusari どくのくさり (Toxic Chain) - # TBD #
doku no toge どくのトゲ (Poison Point) - # TBD #
dokugeshou どくげしょう (Toxic Debris) - Poison Coating
dokushu どくしゅ (Poison Touch) - # TBD #
donkan どんかん (Oblivious) - # TBD #
doshoku どしょく (Earth Eater) - # TBD #
ea rokku エアロック (Air Lock) - Air Lock
enkaku えんかく (Long Reach) - # TBD #
ereki meikaa エレキメイカー (Eletric Surge) - Electric Maker
ereki sukin エレキスキン (Galvanize) - Electric Skin
faa kooto ファーコート (Fur Coat) - Fur Coat
fantomu gaado ファントムガード (Shadow Shield) - Phantom Guard
fearii oora フェアリーオーラ (Fairy Aura) - Fairy Aura
fearii sukin フェアリースキン (Pixilate) - # TBD #
firutaa フィルター (Filter) - Filter
fukashi no kobushi ふかしのこぶし (Unseen Fist) - # TBD #
fukugan ふくがん (Compound Eyes) - # TBD #
fukutsu no kokoro ふくつのこころ (Steadfast) - Steadfast Heart
fukutsu no tate ふくつのたて (Dauntless Shield) - # TBD #
fumin ふみん (Insomnia) - # TBD #
furawaa beeru フラワーベール (Flower Veil) - # TBD #
furawaa gifuto フラワーギフト (Flower Gift) - # TBD #
furendo gaado フレンドガード (Friend Guard) - # TBD #
furiizu sukin フリーズスキン (Refrigerate) - # TBD #
fushigi na uroko ふしぎなうろこ (Marvel Scale) - # TBD #
fushigi na mamori ふしぎなまもり (Wonder Guard) - # TBD #
fushoku ふしょく (Corrosion) - # TBD #
futou no ken ふとうのけん (Intrepid Sword) - # TBD #
fuuryoku denki ふうりょくでんき (Wind Power) - # TBD #
fuyuu ふゆう (Levitate) - # TBD #
ganjou がんじょう (Sturdy) - # TBD #
ganjou ago がんじょうあご (Strong Jaw) - # TBD #
gekiryuu げきりゅう (Torrent) - # TBD #
gitai ぎたい (Mimicry) - Mimicry
gorimuchuu ごりむちゅう (Gorilla Tactics) - # TBD #
gurasu meikaa グラスメイカー (Grassy Surge) - Grass Maker
gyakujou ぎゃくじょう (Berserk) - # TBD #
gyogun ぎょぐん (Schooling) - # TBD #
haado rokku ハードロック (Solid Rock) - # TBD #
hadoron enjin ハドロンエンジン (Hadron Engine) - Hadron Engine
hagane no seishin はがねのせいしん (Steely Spirit) - # TBD #
hagane tsukai はがねつかい (Steelworker) - # TBD #
hajimari no umi はじまりのうみ (Primordial Sea) - # TBD #
hakkou はっこう (Illuminate) - # TBD #
hansuu はんすう (Cud Chew) - # TBD #
harapeko suicchi はらぺこスイッチ (Hunger Switch) - # TBD #
harakiri はりきり (Hustle) - # TBD #
harikomi はりこみ (Stakeout) - # TBD #
hato mune はとむね (Big Pecks) - # TBD #
hayaashi はやあし (Quick Feet) - # TBD #
hayaoki はやおき (Early Bird) - # TBD #
hayate no tsubasa はやてのつばさ (Gale Wings) - # TBD #
hedoro eki ヘドロえき (Liquid Ooze) - # TBD #
hengen jizai へんげんじざい (Protean) - Protean
henshoku へんしょく (Color Change) - # TBD #
hevi metaru ヘヴィメタル (Heavy Metal) - Heavy Metal
hideri ひでり (Drought) - # TBD #
hihi'iro no kodou ひひいろのこどう (Orichalcum Pulse) - # TBD #
hiraishin ひらいしん (Lightning Rod) - # TBD #
hiiringu shifuto ヒーリングシフト (Triage) - # TBD #
hitodenashi ひとでなし (Merciless) - # TBD #
honoo no karada ほのおのからだ (Flame Body) - Flame Body
hoo bukuro ほおぶくろ (Cheek Pouch) - # TBD #
horobi no bodi ほろびのボディ (Perish Body) - # TBD #
houshi ほうし (Effect Spore) - Spore
ikaku いかく (Intimidate) - Intimidate
ikari no koura いかりのこうら (Anger Shell) - # TBD #
ikari no tsubo いかりのつぼ (Anger Point) - # TBD #
iromegane いろめがね (Tinted Lens) - # TBD #
iryuujon イリュージョン (Illusion) - Illusion
ishi atama いしあたま (Rock Head) - # TBD #
itazura gokoro いたずらごころ (Prankster) - # TBD #
iwahakobi いわはこび (Rocky Payload) - # TBD #
iyashi no kokoro いやしのこころ (Healer) - Healing Heart
jikyuuryoku じきゅうりょく (Stamina) - # TBD #
jinba ittai じんばいったい (As One) - # TBD #
jiryoku じりょく (Magnet Pull) - # TBD #
jishin kajou じしんかじょう (Moxie) - # TBD #
joukikan じょうききかん (Steam Engine) - # TBD #
jo'ou no igen じょおうのいげん (Queenly Majesty) - # TBD #
jukusei じゅくせい (Ripen) - # TBD #
juunan じゅうなん (Limber) - # TBD #
kabuto aamaa カブトアーマー (Battle Armor) - # TBD #
kachiki かちき (Competitive) - # TBD #
kagaku henka gasu かがくへんかガス (Neutralizing Gas) - # TBD #
kagaku no chikara かがくのちから (Power of Alchemy) - Power of Science
kage fumin かげふみ (Shadow Tag) - # TBD #
kairiki basami かいりきバサミ (Hyper Cutter) - # TBD #
kanrona mitsu かんろなミツ (Supersweet Syrup) - # TBD #
kansou hada かんそうはだ (Dry Skin) - # TBD #
kaarii heaa カーリーヘアー (Tangling Hair) - # TBD #
karuwaza かるわざ (Unburden) - # TBD #
kasoku かそく (Speed Boost) - # TBD #
katai tsume かたいツメ (Tough Claws) - # TBD #
katayaburi かたやぶり (Mold Breaker) - Mold Breaker
kawari mono かわりもの (Imposter) - # TBD #
kazenori かぜのり (Wind Rider) - # TBD #
kiken yochi きけんよち (Anticipation) - # TBD #
kiki kaihi ききかいひ (Emergency Exit) - # TBD #
kimottama きもったま (Scrappy) - # TBD #
kimyou na kusuri きみょうなくすり (Curious Medicine) - # TBD #
kinchoukan きんちょうかん (Unnerve) - # TBD #
kinshi no chikara きんしのちから (Mycelium Might) - # TBD #
kireaji きれあじ (Sharpness) - # TBD #
kiyome no shio きよめのしお (Purifying Salt) - # TBD #
kizuna henge きずなへんげ (Battle Bond) - # TBD #
kobore dane こぼれダネ (Seed Sower) - Falling Seeds
kodaikassei こだいかっせい (Protosynthesis) - Ancient Activation
kongari bodi こんがりボディ (Well-Baked Body) - # TBD #
konjou こんじょう (Guts) - # TBD #
koori no rinpun こおりのりんぷん (Ice Scales) - # TBD #
kudakeru yoroi くだけるよろい (Weak Armor) - Breaking Armor
kuikku doroo クイックドロウ (Quick Draw) - Quick Draw
kuishinbou くいしんぼう (Gluttony) - # TBD #
kuooku chaaji クォークチャージ (Quark Drive) - # TBD #
kuria bodi クリアボディ (Clear Body) - Clear Body
kuro no inanaki くろのいななき (Grim Neigh) - # TBD #
kusa no kegawa くさのけがわ (Grass Pelt) - # TBD #
kyouen きょうえん (Costar) - # TBD #
kyousei きょうせい (Symbiosis) - # TBD #
kyouun きょううん (Super Luck) - # TBD #
kyuuban きゅうばん (Suction Cups) - # TBD #
maguma no yoroi マグマのよろい (Magma Armor) - # TBD #
mai peesu マイペース (Own Tempo) - # TBD #
mainasu マイナス (Minus) - Minus
maiti chenji マイティチェンジ (Zero to Hero) - Mighty Change
majikku gaado マジックガード (Magic Guard) - Magic Guard
majikku miraa マジックミラー (Magic Bounce) - Magic Mirror
majishan マジシャン (Magician) - # TBD #
makenki まけんき (Defiant) - # TBD #
maruchisukeiru マルチスケイル (Multiscale) - Multiscale
maruchitaipu マルチタイプ (Multitype) - Multitype
mega ranchaa メガランチャー (Mega Launcher) - Mega Launcher
men'eki めんえき (Immunity) - # TBD #
meromero bodi メロメロボディ (Cute Charm) - # TBD #
metaru purotekuto メタルプロテクト (Full Metal Body) - # TBD #
miira ミイラ (Mummy) - # TBD #
miraa aamaa ミラーアーマー (Mirror Armor) - Mirror Armor
mirakuru sukin ミラクルスキン (Wonder Skin) - Miracle Skin
misuto meikaa ミストメイカー (Misty Surge) - Mist Maker
mitsu atsume みつあつめ (Honey Gather) - # TBD #
mizu gatame みずがため (Water Compaction) - # TBD #
mizu no beeru みずのベール (Water Veil) - # TBD #
mofumofu もふもふ (Fluffy) - # TBD #
mouka もうか (Blaze) - # TBD #
mono hiroi ものひろい (Pickup) - # TBD #
moraibi もらいび (Flash Fire) - Kindled Fire
murakke ムラっけ (Moody) - # TBD #
mushi no shirase むしのしらせ (Swarm) - Bugout
naitomea ナイトメア (Bad Dreams) - Nightmare
namake なまけ (Truant) - # TBD #
nenchaku ねんちゃく (Sticky Hold) - Sticky Hold
netsu bousou ねつぼうそう (Flare Boost) - # TBD #
netsu koukan ねつこうかん (Thermal Exchange) - Thermal Exchange
nige ashi にげあし (Run Away) - # TBD #
nigegoshi にげごし (Wimp Out) - # TBD #
noo gaado ノーガード (No Guard) - No Guard
noo tenki ノーてんき (Cloud Nine) - # TBD #
noomaru sukin ノーマルスキン (Normalize) - # TBD #
noroware bodi のろわれボディ (Cursed Body) - # TBD #
numenume ぬめぬめ (Gooey) - # TBD #
odoriko おどりこ (Dancer) - # TBD #
omitooshi おみとおし (Frisk) - # TBD #
omokage yadoshi おもかげやどし (Embody Aspect) - # TBD #
omotenashi おもてなし (Hospitality) - # TBD #
oora bureiku オーラブレイク (Aura Break) - Aura Break
ougon no karada おうごんのからだ (Good as Gold) - Golden Body
owari no daichi おみとおし (Desolate Land) - # TBD #
oyaki ai おやこあい (Parental Bond) - # TBD #
panku rokku パンクロック (Punk Rock) - Punk Rock
pasuteru beeru パステルベール (Pastel Veil) - Pastel Veil
pawaa supotto パワースポット (Power Spot) - Power Spot
poizun hiiru ポイズンヒール (Poison Heal) - Poison Heal
purasu プラス (Plus) - Plus
puresshaa プレッシャー (Pressure) - Pressure
purizumu aamaa プリズムアーマー (Prism Armor) - Prism Armor
raito metaru ライトメタル (Light Metal) - Light Metal
reshiibaa レシーバー (Receiver) - Receiver
ribero リベロ (Libero) - Libero
riifu gaado リーフガード (Leaf Guard) - Leaf Guard
rimitto shiirudo リミットシールド (Shields Down) - # TBD #
rinpun りんぷん (Shield Dust) - # TBD #
ryuu no agito りゅうのあぎと (Dragon's Maw) - # TBD #
saafu teeru サーフテール (Surge Surfer) - # TBD #
saiko meikaa サイコメイカー (Psychic Surge) - Psycho Maker
saiseiryoku さいせいりょく (Regenerator) - # TBD #
samayou tamashii さまようたましい (Wandering Spirit) - # TBD #
samehada さめはだ (Rough Skin) - # TBD #
san pawaa サンパワー (Solar Power) - # TBD #
seidenki せいでんき (Static) - Static
seigi no kokoro せいぎのこころ (Justified) - Heart of Justice
seishinryoku せいしんりょく (Inner Force) - Force of Will
sheru aamaa シェルアーマー (Shell Armor) - Shell Armor
shimerike しめりけ (Damp) - # TBD #
shingan しんがん (Mind's Eye) - # TBD #
shinkuro シンクロ (Synchronize) - # TBD #
shinryoku しんりょく (Overgrow) - Budding Greenery
shireitou しれいとう (Commander) - # TBD #
shiro no inanaki しろのいななき (Chilling Neigh) - # TBD #
shiroi kemuri しろいけむり (White Smoke) - White Smoke
shizen kaifuku しぜんかいふく (Natural Cure) - Natural Cure
shouri no hoshi しょうりのほし (Victory Star) - # TBD #
shuukaku しゅうかく (Harvest) - # TBD #
sou on そうおん (Cacophony) - # TBD #
soudaishou そうだいしょう (Supreme Overlord) - # TBD #
souru haato ソウルハート (Soul-Heart) - Soul Heart
soushoku そうしょく (Sap Sipper) - # TBD #
suihou すいほう (Water Bubble) - # TBD #
suisui すいすい (Swift Swim) - # TBD #
suiito beeru スイートベール (Sweet Veil) - Sweet Veil
sujiganeiri すじがねいり (Stalwart) - # TBD #
sukai sukin スカイスキン (Aerilate) - # TBD #
sukuryuu obire スクリューおびれ (Propeller Tail) - # TBD #
sukiru rinku スキルリンク (Skill Link) - Skill Link
suna haki すなはき (Sand Spit) - # TBD #
suna no chikara すなのちから (Sand Force) - # TBD #
suna okoshi すなおこし (Sand Stream) - # TBD #
sunagakure すながくれ (Sand Veil) - # TBD #
sunaipaa スナイパー (Sniper) - Sniper
sunakaki すなかき (Sand Rush) - # TBD #
surinuke すりぬけ (Infiltrator) - # TBD #
suroo sutaato スロースタート (Slow Start) - Slow Start
surudoi me するどいめ (Keen Eyes) - # TBD #
sutemi すてみ (Reckless) - # TBD #
suwaamu chenji スワームチェンジ (Power Construct) - # TBD #
taabobureizu ターボブレイズ (Turboblaze) - Turboblaze
tainetsu たいねつ (Heatproof) - # TBD #
tama hiroi たまひろい (Ball Fetch) - # TBD #
tanjun たんじゅん (Simple) - # TBD #
teiru aamaa テイルアーマー (Armor Tail) - # TBD #
tekiouryouku てきおうりょく (Adaptability) - Adaptability
tekunishan テクニシャン (Technician) - Technician
ten no megumi てんのめぐみ (Serene Grace) - Heaven's Blessings
tenkiya てんきや (Forecast) - # TBD #
tennen てんねん (Unaware) - # TBD #
tera chenji テラスチェンジ (Tera Shift) - Tera Change
tera sheru テラスシェル (Tera Shell) - Tera Shell
teraboruteeji テラボルテージ (Teravolt) - # TBD #
terepashii テレパシー (Telepathy) - Telepathy
tetsu no kobushi てつのこぶし (Iron Fist) - Iron Fist
tetsu no toge てつのトゲ (Iron Barbs) - Iron Barbs
tobidasu nakami とびだすなかみ (Innards Out) - # TBD #
toranjisuta トランジスタ (Transistor) - Transistor
toreesu トレース (Trace) - Trace
torenai nioi とれないにおい (Lingering Aroma) - # TBD #
tousoushin とうそうしん (Rivalry) - # TBD #
u no misairu うのミサイル (Gulp Missile) - # TBD #
uruoi bodi うるおいボディ (Hydration) - # TBD #
uruoi boisu うるおいボイス (Liquid Voice) - # TBD #
waruite guse わるいてぐせ (Pickpocket) - # TBD #
watage わたげ (Cotton Down) - # TBD #
wazawai no ofuda わざわいのおふだ (Tablets of Ruin) - # TBD #
wazawai no tama わざわいのたま (Beads of Ruin) - # TBD #
wazawai no tsurugi わざわいのつるぎ (Sword of Ruin) - # TBD #
wazawai no utsawa わざわいのうつわ (Vessel of Ruin) - # TBD #
yaruki やるき (Vital Spirit) - # TBD #
yobimizu よびみず (Storm Drain) - # TBD #
yochimu よちむ (Forewarn) - # TBD #
yoga pawaa ヨガパワー (Pure Power) - # TBD #
youryokuso ようりょくそ (Chlorophyll) - # TBD #
yowaki よわき (Defeatist) - # TBD #
yuki furashi ゆきふらし (Snow Warning) - # TBD #
yuki kaki ゆきかき (Slush Rush) - # TBD #
yukigakure ゆきがくれ (Snow Cloak) - # TBD #
yuubaku ゆうばく (Aftermath) - Induced Explosion
zero foomingu ゼロフォーミング (Teraform Zero) - Zero-Forming
zettai nemuri ぜったいねむり (Comatose) - Hyper Sleep



POKÉMON NAMES

0001 フシギダネ Fushigidane - たねポケモン Seed Pokémon
0002 フシギソウ Fushigisou - たねポケモン Seed Pokémon
0003 フシギバナ Fushigibana - たねポケモン Seed Pokémon
0004 ヒトカゲ Hitokage - とかげポケモン Lizard Pokémon
0005 リザード Lizard - かえんポケモン Flame Pokémon
0006 リザードン Lizardon - かえんポケモン Flame Pokémon
0007 ゼニガメ Zenigame - かめのこポケモン 
0008 カメール Kameil - かめポケモン Turtle Pokémon
0009 カメックス Kamex - こうらポケモン 
0010 キャタピー Caterpie - いもむしポケモン Caterpillar Pokémon
0011 トランセル Trancell - さなぎポケモン Chrysalis Pokémon
0012 バタフリー Butterfree - ちょうちょポケモン Butterfly Pokémon
0013 ビードル Beedle - けむしポケモン 
0014 コクーン Cocoon - さなぎポケモン Chrysalis Pokémon
0015 スピアー Spear - どくばちポケモン 
0016 ポッポ Poppo - ことりポケモン Tiny Bird Pokémon
0017 ピジョン Pidgeon - とりポケモン Bird Pokémon
0018 ピジョット Pidgeot - とりポケモン Bird Pokémon
0019 コラッタ Koratta - ねずみポケモン Mouse Pokémon
0020 ラッタ Ratta - ねずみポケモン Mouse Pokémon
0021 オニスズメ Onisuzume - ことりポケモン Tiny Bird Pokémon
0022 オニドリル Onidrill - くちばしポケモン Beak Pokémon
0023 アーボ Abo - へびポケモン Snake Pokémon
0024 アーボック Arbok - コブラポケモン Cobra Pokémon
0025 ピカチュウ Pikachu - ねずみポケモン Mouse Pokémon
0026 ライチュウ Raichu - ねずみポケモン Mouse Pokémon
0027 サンド Sand - ねずみポケモン Mouse Pokémon
0028 サンドパン Sandpan - ねずみポケモン Mouse Pokémon
0029 ニドラン♀ Nidoran - どくばりポケモン Poison Needle Pokémon
0030 ニドリーナ Nidorina - どくばりポケモン Poison Needle Pokémon
0031 ニドクイン Nidoqueen - ドリルポケモン Drill Pokémon
0032 ニドラン♂ Nidoran - どくばりポケモン Poison Needle Pokémon
0033 ニドリーノ Nidorino - どくばりポケモン Poison Needle Pokémon
0034 ニドキング Nidoking - ドリルポケモン Drill Pokémon
0035 ピッピ Pippi - ようせいポケモン Fairy Pokémon
0036 ピクシー Pixie - ようせいポケモン Fairy Pokémon
0037 ロコン Rokon - きつねポケモン Fox Pokémon
0038 キュウコン Kyukon - きつねポケモン Fox Pokémon
0039 プリン Purin - ふうせんポケモン Balloon Pokémon
0040 プクリン Pukurin - ふうせんポケモン Balloon Pokémon
0041 ズバット Zubat - こうもりポケモン Bat Pokémon
0042 ゴルバット Golbat - こうもりポケモン Bat Pokémon
0043 ナゾノクサ Nazonokusa - ざっそうポケモン 
0044 クサイハナ Kusaihana - ざっそうポケモン 
0045 ラフレシア Rafflesia - フラワーポケモン Flower Pokémon
0046 パラス Paras - きのこポケモン Mushroom Pokémon
0047 パラセクト Parasect - きのこポケモン Mushroom Pokémon
0048 コンパン Konpang - こんちゅうポケモン 
0049 モルフォン Morphon - どくがポケモン 
0050 ディグダ Digda - もぐらポケモン Mole Pokémon
0051 ダグトリオ Dugtrio - もぐらポケモン Mole Pokémon
0052 ニャース Nyarth - ばけねこポケモン Monster Cat Pokémon
0053 ペルシアン Persian - シャムネコポケモン Siamese Cat Pokémon
0054 コダック Koduck - あひるポケモン Duck Pokémon
0055 ゴルダック Golduck - あひるポケモン Duck Pokémon
0056 マンキー Mankey - ぶたざるポケモン Pig Monkey Pokémon
0057 オコリザル Okorizaru - ぶたざるポケモン Pig Monkey Pokémon
0058 ガーディ Guardie - こいぬポケモン Puppy Pokémon | Hisuian Form - みはりポケモン Scout Pokémon
0059 ウインディ Windie - でんせつポケモン Legend Pokémon
0060 ニョロモ Nyoromo - おたまポケモン Tadpole Pokémon
0061 ニョロゾ Nyorozo - おたまポケモン Tadpole Pokémon
0062 ニョロボン Nyorobon - おたまポケモン Tadpole Pokémon
0063 ケーシィ Cayce - ねんりきポケモン Mind Power Pokémon
0064 ユンゲラー Ungeller - ねんりきポケモン Mind Power Pokémon
0065 フーディン Houdin - ねんりきポケモン Mind Power Pokémon
0066 ワンリキー Wanriky - かいりきポケモン Superstrength Pokémon
0067 ゴーリキー Goriky - かいりきポケモン Superstrength Pokémon
0068 カイリキー Kairiky - かいりきポケモン Superstrength Pokémon
0069 マダツボミ Madatsubomi - フラワーポケモン Flower Pokémon
0070 ウツドン 
0071 ウツボット Utsubot - ハエとりポケモン 
0072 メノクラゲ Menokurage - くらげポケモン 
0073 ドククラゲ Dokukurage - くらげポケモン 
0074 イシツブテ Ishitsubute - がんせきポケモン Rock Pokémon
0075 ゴローン Gorone - がんせきポケモン Rock Pokémon
0076 ゴローニャ Gorogna - メガトンポケモン Megaton Pokémon
0077 ポニータ Ponyta - ひのうまポケモン Fire Horse Pokémon | Galarian Form - いっかくポケモン One-Horned Pokémon
0078 ギャロップ Gallop - ひのうまポケモン Fire Horse Pokémon | Galarian Form - いっかくポケモン One-Horned Pokémon
0079 ヤドン Yadon - まぬけポケモン Dopey Pokémon
0080 ヤドラン Yadoran - やどかりポケモン Hermit Crab Pokémon
0081 コイル Coil - じしゃくポケモン Magnet Pokémon
0082 レアコイル Rarecoil - じしゃくポケモン Magnet Pokémon
0083 カモネギ Kamonegi - かるがもポケモン Spot-Billed Duck Pokémon
0084 ドードー Dodo - ふたごどりポケモン 
0085 ドードリオ Dodorio - みつごどりポケモン 
0086 パウワウ Pawou - あしかポケモン Sea Lion Pokémon
0087 ジュゴン Dugong - あしかポケモン Sea Lion Pokémon
0088 ベトベター Betobeta - ヘドロポケモン 
0089 ベトベトン Betobeton - ヘドロポケモン 
0090 シェルダー Shellder - 2まいがい 
0091 パルシェン Pearshen - 2まいがい 
0092 ゴース Ghos - ガスじょうポケモン Gaseous Pokémon
0093 ゴースト Ghost - ガスじょうポケモン Gaseous Pokémon
0094 ゲンガー Gänger - シャドーポケモン Shadow Pokémon
0095 イワーク Iwark - いわへびポケモン Rock Snake Pokémon
0096 スリープ Sleep - さいみんポケモン Hypnosis Pokémon
0097 スリーパー Sleeper - さいみんポケモン Hypnosis Pokémon
0098 クラブ Crab - さわがにポケモン Freshwater Crab Pokémon
0099 キングラー Kingler - はさみポケモン Pincer Pokémon
0100 ビリリダマ Biriridama - ボールポケモン Ball Pokémon | Hisuian Form - きゅうたいポケモン 
0101 マルマイン Marumine - ボールポケモン Ball Pokémon | Hisuian Form - きゅうたいポケモン 
0102 タマタマ Tamatama - たまごポケモン Egg Pokémon
0103 ナッシー Nasshi - やしのみポケモン Coconut Pokémon
0104 カラカラ Karakara - こどくポケモン Lonely Pokémon
0105 ガラガラ Garagara - ほねずきポケモン 
0106 サワムラー Sawamurar - キックポケモン 
0107 エビワラー Ebiwarar - パンチポケモン 
0108 ベロリンガ Berolinga - なめまわしポケモン Licking Pokémon
0109 ドガース Dogas - どくガスポケモン Poison Gas Pokémon
0110 マタドガス Matadogas - どくガスポケモン Poison Gas Pokémon
0111 サイホーン Saihorn - とげとげポケモン
0112 サイドン Saidon - ドリルポケモン Drill Pokémon
0113 ラッキー Lucky - たまごポケモン Egg Pokémon
0114 モンジャラ 
0115 ガルーラ Garura - おやこポケモン Parent and Child Pokémon
0116 タッツー Tattsu - ドラゴンポケモン Dragon Pokémon
0117 シードラ Seadra - ドラゴンポケモン Dragon Pokémon
0118 トサキント Tosakinto - きんぎょポケモン Goldfish Pokémon
0119 アズマオウ Azumao - きんぎょポケモン Goldfish Pokémon
0120 ヒトデマン Hitodeman - ほしがたポケモン Star Shape Pokémon
0121 スターミー Starmie - なぞのポケモン 
0122 バリヤード Barrierd - バリアーポケモン Barrier Pokémon | Galarian Form - ダンスポケモン Dancing Pokémon
0123 ストライク Strike - かまきりポケモン Mantis Pokémon
0124 ルージュラ 
0125 エレブー Eleboo - でんげきポケモン Electric Shock Pokémon
0126 ブーバー Boobur - ひふきポケモン 
0127 カイロス Kaiross - くわがたポケモン Stag Beetle Pokémon
0128 ケンタロス Kentauros - あばれうしポケモン Wild Bull Pokémon
0129 コイキング Koiking - さかなポケモン Fish Pokémon
0130 ギャラドス Gyarados - きょうあくポケモン Atrocious Pokémon
0131 ラプラス Laplace - のりものポケモン Transport Pokémon
0132 メタモン Metamon - へんしんポケモン Transform Pokémon
0133 イーブイ Eevee - しんかポケモン Evolution Pokémon
0134 シャワーズ Showers - あわはきポケモン Bubble Jet Pokémon
0135 サンダース Thunders - かみなりポケモン Lightning Pokémon
0136 ブースター Booster - ほのおポケモン Fire Pokémon
0137 ポリゴン Porygon - バーチャルポケモン Virtual Pokémon
0138 オムナイト Omunyte - うずまきポケモン 
0139 オムスター Omustar - うずまきポケモン 
0140 カブト Kabuto - こうらポケモン 
0141 カブトプス Kabutops - こうらポケモン 
0142 プテラ Ptera - かせきポケモン Fossil Pokémon
0143 カビゴン Kabigon - いねむりポケモン Sleeping Pokémon
0144 フリーザー Freezer - れいとうポケモン Freezing Pokémon | Galarian Form - れいこくポケモン 
0145 サンダー Thunder - でんげきポケモン Electric Shock Pokémon | Galarian Form - けんきゃくポケモン 
0146 ファイヤー Fire - かえんポケモン Flame Pokémon | Galarian Form - じゃあくポケモン Malevolent Pokémon
0147 ミニリュウ Miniryu - ドラゴンポケモン Dragon Pokémon
0148 ハクリュー Hakuryu - ドラゴンポケモン Dragon Pokémon
0149 カイリュー Kairyu - ドラゴンポケモン Dragon Pokémon
0150 ミュウツー Mewtwo - いでんしポケモン 
0151 ミュウ Mew - しんしゅポケモン 
0152 チコリータ Chicorita - はっぱポケモン Leaf Pokémon
0153 ベイリーフ Bayleaf - はっぱポケモン Leaf Pokémon
0154 メガニウム Meganium - ハーブポケモン Herb Pokémon
0155 ヒノアラシ Hinoarashi - ひねずみポケモン Fire Mouse Pokémon
0156 マグマラシ Magmarashi - かざんポケモン 
0157 バクフーン Bakuphoon - かざんポケモン 
0158 ワニノコ Waninoko - おおあごポケモン 
0159 アリゲイツ 
0160 オーダイル Ordile - おおあごポケモン 
0161 オタチ Otachi - みはりポケモン Scout Pokémon
0162 オオタチ Ootachi - どうながポケモン 
0163 ホーホー Hoho - ふくろうポケモン 
0164 ヨルノズク Yorunozuku - ふくろうポケモン 
0165 レディバ Ledyba - いつつぼしポケモン 
0166 レディアン Ledian - いつつぼしポケモン 
0167 イトマル 
0168 アリアドス Ariados - あしながポケモン 
0169 クロバット Crobat - こうもりポケモン Bat Pokémon
0170 チョンチー Chonchie - あんこうポケモン 
0171 ランターン 
0172 ピチュー Pichu - こねずみポケモン 
0173 ピィ Pi - ほしがたポケモン Star Shape Pokémon
0174 ププリン Pupurin - ふうせんポケモン Balloon Pokémon
0175 トゲピー Togepi - はりたまポケモン 
0176 トゲチック Togechick - しあわせポケモン Happiness Pokémon
0177 ネイティ Naty - ことりポケモン Tiny Bird Pokémon
0178 ネイティオ Natio - せいれいポケモン Spirit Pokémon
0179 メリープ Mareep - わたげポケモン 
0180 モココ Mokoko - わたげポケモン 
0181 デンリュウ Denryuu - ライトポケモン Light Pokémon
0182 キレイハナ Kireihana - フラワーポケモン Flower Pokémon
0183 マリル Marill - みずねずみポケモン 
0184 マリルリ Marilluri - みずうさぎポケモン
0185 ウソッキー Usokki - まねポケモン Imitation Pokémon
0186 ニョロトノ Nyorotono - かえるポケモン 
0187 ハネッコ Hanekko - わたくさポケモン 
0188 ポポッコ Popokko - わたくさポケモン 
0189 ワタッコ Watakko - わたくさポケモン 
0190 エイパム Apalm - おながポケモン 
0191 ヒマナッツ 
0192 キマワリ Kimawari - たいようポケモン Sun Pokémon
0193 ヤンヤンマ 
0194 ウパー Wooper - みずうおポケモン Water Fish Pokémon | Paldean Form - どくうおポケモン Poison Fish Pokémon
0195 ヌオー Nuoh - みずうおポケモン Water Fish Pokémon
0196 エーフィ Eefee - たいようポケモン Sun Pokémon
0197 ブラッキー Blacky - げっこうポケモン Moonlight Pokémon
0198 ヤミカラス Yamikarasu - くらやみポケモン Darkness Pokémon
0199 ヤドキング Yadoking - おうじゃポケモン Monarch Pokémon
0200 ムウマ Muma - よなきポケモン Night Screeching Pokémon
0201 アンノーン Unknown - シンボルポケモン Symbol Pokémon
0202 ソーナンス Sonansu - がまんポケモン 
0203 キリンリキ Kirinriki - くびながポケモン Long Neck Pokémon
0204 クヌギダマ Kunugidama - みのむしポケモン Bagworm Pokémon
0205 フォレトス Foretos - みのむしポケモン Bagworm Pokémon
0206 ノコッチ Nokotchi - つちへびポケモン Land Snake Pokémon
0207 グライガー 
0208 ハガネール Haganail - てつへびポケモン Iron Snake Pokémon
0209 ブルー Bullu - ようせいポケモン Fairy Pokémon
0210 グランブル Granbull - ようせいポケモン Fairy Pokémon
0211 ハリーセン Harisen - ふうせんポケモン Balloon Pokémon
0212 ハッサム Hassam - はさみポケモン Pincer Pokémon
0213 ツボツボ Tsubotsubo - はっこうポケモン 
0214 ヘラクロス Heracross - 1ぽんヅノポケモン Single Horn Pokémon
0215 ニューラ Nyula - かぎづめポケモン 
0216 ヒメグマ Himeguma - こぐまポケモン Little Bear Pokémon
0217 リングマ Ringuma - とうみんポケモン 
0218 マグマッグ 
0219 マグカルゴ 
0220 ウリムー 
0221 イノムー 
0222 サニーゴ Sunnygo - さんごポケモン Coral Pokémon
0223 テッポウオ Teppouo - ふんしゃポケモン 
0224 オクタン Octan - ふんしゃポケモン 
0225 デリバード Delibird - はこびやポケモン 
0226 マンタイン Mantine - カイトポケモン Kite Pokémon
0227 エアームド Airm'd - よろいどりポケモン Armor Bird Pokémon
0228 デルビル Delvil - ダークポケモン Dark Pokémon
0229 ヘルガー Hellgar - ダークポケモン Dark Pokémon
0230 キングドラ Kingdra - ドラゴンポケモン Dragon Pokémon
0231 ゴマゾウ Gomazo - ながはなポケモン 
0232 ドンファン Donphan - よろいポケモン Armor Pokémon
0233 ポリゴン２ 
0234 オドシシ Odoshishi - おおツノポケモ 
0235 ドーブル Doble - えかきポケモン Painter Pokémon
0236 バルキー 
0237 カポエラー Capoeirer - さかだちポケモン Handstand Pokémon
0238 ムチュール 
0239 エレキッド Elekid - でんきポケモン Electric Pokémon
0240 ブビィ Booby - ひだねポケモン 
0241 ミルタンク Miltank - ちちうしポケモン 
0242 ハピナス Happinus - しあわせポケモン Happiness Pokémon
0243 ライコウ Raikou - いかずちポケモン 
0244 エンテイ Entei - かざんポケモン Volcano Pokémon
0245 スイクン Suikun - オーロラポケモン Aurora Pokémon
0246 ヨーギラス Yoguirus - いわはだポケモン 
0247 サナギラス Sanaguirus - だんがんポケモン 
0248 バンギラス Banguirus - よろいポケモン Armor Pokémon
0249 ルギア Lugia - せんすいポケモン 
0250 ホウオウ Houou - にじいろポケモン 
0251 セレビィ Celebi - ときわたりポケモン Time Travel Pokémon
0252 キモリ Kimori - もりトカゲポケモン 
0253 ジュプトル Juptile - もりトカゲポケモン 
0254 ジュカイン Jukain - みつりんポケモン 
0255 アチャモ Achamo - ひよこポケモン 
0256 ワカシャモ Wakashamo - わかどりポケモン 
0257 バシャーモ Burshamo - もうかポケモン 
0258 ミズゴロウ Mizugoro - ぬまうおポケモン Swamp Fish Pokémon
0259 ヌマクロー Numacraw - ぬまうおポケモン Swamp Fish Pokémon
0260 ラグラージ Laglarge - ぬまうおポケモン Swamp Fish Pokémon
0261 ポチエナ Poochyena - かみつきポケモン Bite Pokémon
0262 グラエナ Graena - かみつきポケモン Bite Pokémon
0263 ジグザグマ Zigzaguma - まめだぬきポケモン 
0264 マッスグマ Massuguma - とっしんポケモン 
0265 ケムッソ Kemusso - いもむしポケモン Caterpillar Pokémon
0266 カラサリス Karasalis - さなぎポケモン Chrysalis Pokémon
0267 アゲハント Agehunt - ちょうちょポケモン Butterfly Pokémon
0268 マユルド Mayuld - さなぎポケモン Chrysalis Pokémon
0269 ドクケイル Dokucale - どくがポケモン 
0270 ハスボー Hasuboh - うきくさポケモン 
0271 ハスブレロ Hasubrero - ようきポケモン 
0272 ルンパッパ Runpappa - のうてんきポケモン Carefree Pokémon
0273 タネボー 
0274 コノハナ 
0275 ダーテング Dirtengu - よこしまポケモン 
0276 スバメ Subame - こツバメポケモン 
0277 オオスバメ Ohsubame - ツバメポケモン 
0278 キャモメ Camome - うみねこポケモン 
0279 ペリッパー Pelipper - みずどりポケモン Water Bird Pokémon
0280 ラルトス 
0281 キルリア 
0282 サーナイト Sirknight - ほうようポケモン 
0283 アメタマ Ametama - あめんぼポケモン Pond Skater Pokémon
0284 アメモース Amemoth - めだまポケモン 
0285 キノココ Kinokoko - きのこポケモン Mushroom Pokémon
0286 キノガッサ Kinogassa - きのこポケモン Mushroom Pokémon
0287 ナマケロ Namakero - なまけものポケモン Slacker Pokémon
0288 ヤルキモノ Yarukimono - あばれザルポケモン 
0289 ケッキング Kekking - ものぐさポケモン Lazy Pokémon
0290 ツチニン Tsuchinin - したづみポケモン Trainee Pokémon
0291 テッカニン Tekkanin - しのびポケモン Shinobi Pokémon
0292 ヌケニン Nukenin - ぬけがらポケモン Shed Shell Pokémon
0293 ゴニョニョ Gonyonyo - ささやきポケモン Whisper Pokémon
0294 ドゴーム Dogomb - おおごえポケモン Loud Voice Pokémon
0295 バクオング 
0296 マクノシタ 
0297 ハリテヤマ Hariteyama - つっぱりポケモン Arm Thrust Pokémon
0298 ルリリ Ruriri - みずたまポケモン 
0299 ノズパス Nosepass - コンパスポケモン Compass Pokémon
0300 エネコ Eneko - こねこポケモン 
0301 エネコロロ 
0302 ヤミラミ Yamirami - くらやみポケモン Darkness Pokémon
0303 クチート Kucheat - あざむきポケモン 
0304 ココドラ Kokodra - てつヨロイポケモン Iron Armor Pokémon
0305 コドラ Kodra - てつヨロイポケモン Iron Armor Pokémon
0306 ボスゴドラ Bossgodra - てつヨロイポケモン Iron Armor Pokémon
0307 アサナン Asanan - めいそうポケモン 
0308 チャーレム Charem - めいそうポケモン 
0309 ラクライ 
0310 ライボルト 
0311 プラスル Plusle - おうえんポケモン Cheering Pokémon
0312 マイナン Minun - おうえんポケモン Cheering Pokémon
0313 バルビート 
0314 イルミーゼ 
0315 ロゼリア Roselia - いばらポケモン 
0316 ゴクリン Gokurin - いぶくろポケモン 
0317 マルノーム Marunomu - どくぶくろポケモン 
0318 キバニア Kibanha - どうもうポケモン Savage Pokémon
0319 サメハダー Samehada - きょうぼうポケモン Brutal Pokémon
0320 ホエルコ Whaleko - たまくじらポケモン 
0321 ホエルオー Whaleoh - うきくじらポケモン Float Whale Pokémon
0322 ドンメル Donmel - どんかんポケモン 
0323 バクーダ Bakuda - ふんかポケモン 
0324 コータス Cortoise - せきたんポケモン Coal Pokémon
0325 バネブー Baneboo - とびはねポケモン
0326 ブーピッグ 
0327 パッチール 
0328 ナックラー Nuckrar - ありじごくポケモン Ant Pit Pokémon
0329 ビブラーバ Vibrava - しんどうポケモン Vibration Pokémon
0330 フライゴン Flygon - せいれいポケモン Spirit Pokémon
0331 サボネア 
0332 ノクタス 
0333 チルット Tyltto - わたどりポケモン Cotton Bird Pokémon
0334 チルタリス Tyltalis - ハミングポケモン Humming Pokémon
0335 ザングース Zangoose - ネコイタチポケモン 
0336 ハブネーク Habunake - キバへびポケモン 
0337 ルナトーン Lunatone - いんせきポケモン Meteorite Pokémon
0338 ソルロック Solrock - いんせきポケモン Meteorite Pokémon
0339 ドジョッチ 
0340 ナマズン Namazun - ひげうおポケモン 
0341 ヘイガニ Heigani - ごろつきポケモン 
0342 シザリガー Scizarigar - ならずものポケモン Rogue Pokémon
0343 ヤジロン 
0344 ネンドール 
0345 リリーラ 
0346 ユレイドル Yuradle - いわつぼポケモン Rock Crevice Pokémon
0347 アノプス Anopth - むかしエビポケモン 
0348 アーマルド Armaldo - かっちゅうポケモン Plate Pokémon
0349 ヒンバス Hinbass - さかなポケモン Fish Pokémon
0350 ミロカロス Milokallos - いつくしみポケモン Affection Pokémon
0351 ポワルン Powarun - てんきポケモン Weather Pokémon
0352 カクレオン Kakuleon - いろへんげポケモン Color Swap Pokémon
0353 カゲボウズ Kagebouzu - にんぎょうポケモン 
0354 ジュペッタ Jupetta - ぬいぐるみポケモン Plush Doll Pokémon
0355 ヨマワル Yomawaru - おむかえポケモン 
0356 サマヨール Samayouru - てまねきポケモン Beckon Pokémon
0357 トロピウス Tropius - フルーツポケモン Fruit Pokémon
0358 チリーン Chiriin - ふうりんポケモン 
0359 アブソル Absol - わざわいポケモン Disaster Pokémon
0360 ソーナノ Sonano - ほがらかポケモン 
0361 ユキワラシ Yukiwarashi - ゆきかさポケモン Snow Hat Pokémon
0362 オニゴーリ Onigohri - がんめんポケモン Face Pokémon
0363 タマザラシ Tamazarashi - てたたきポケモン 
0364 トドグラー 
0365 トドゼルガ Todoserga - こおりわりポケモン 
0366 パールル Pearlulu - 2まいがいポケモン 
0367 ハンテール Huntail - しんかいポケモン Deep Sea Pokémon
0368 サクラビス Sakurabyss - なんかいポケモン South Sea Pokémon
0369 ジーランス Jilanth - ちょうじゅポケモン 
0370 ラブカス Lovecus - ランデブーポケモン Rendezvous Pokémon
0371 タツベイ 
0372 コモルー Komoru - にんたいポケモン 
0373 ボーマンダ Bohmander - ドラゴンポケモン Dragon Pokémon
0374 ダンバル Dumbball - てっきゅうポケモン 
0375 メタング Metang - てつツメポケモン 
0376 メタグロス Metagross - てつあしポケモン 
0379 レジロック Regirock - いわやまポケモン 
0378 レジアイス Regice - ひょうざんポケモン Iceberg Pokémon
0379 レジスチル Registeel - くろがねポケモン 
0380 ラティアス Latias - むげんポケモン Boundless Pokémon
0381 ラティオス Latios - むげんポケモン Boundless Pokémon
0382 カイオーガ Kaiogre - かいていポケモン Sea Basin Pokémon
0383 グラードン Groudon - たいりくポケモン 
0384 レックウザ Rekkuuza - てんくうポケモン Heavens Pokémon
0385 ジラーチ Jirachi - ねがいごとポケモン 
0386 デオキシス 
0387 ナエトル Naetle - わかばポケモン 
0388 ハヤシガメ 
0389 ドダイトス Dodaitoise - たいりくポケモン 
0390 ヒコザル Hikozaru - こざるポケモン Chimp Pokémon
0393 モウカザル 
0392 ゴウカザル Goukazaru - かえんポケモン Flame Pokémon
0393 ポッチャマ Pochama - ペンギンポケモン Penguin Pokémon
0394 ポッタイシ 
0395 エンペルト Emperte - こうていポケモン Emperor Pokémon
0396 ムックル Mukkuru - むくどりポケモン Starling Pokémon
0397 ムクバード 
0398 ムクホーク Mukuhawk - もうきんポケモン 
0399 ビッパ 
0400 ビーダル Beadaru - ビーバーポケモン 
0401 コロボーシ Koroboushi - こおろぎポケモン Cricket Pokémon
0402 コロトック Korotock - こおろぎポケモン Cricket Pokémon
0403 コリンク 
0404 ルクシオ 
0405 レントラー Rentorar - がんこうポケモン Gleam Eyes Pokémon
0406 スボミー Subomi - つぼみポケモン 
0407 ロズレイド Roserade - ブーケポケモン Bouquet Pokémon
0408 ズガイドス Zugaidos - ずつきポケモン
0409 ラムパルド Rampard - ずつきポケモン 
0410 タテトプス Tatetops - シールドポケモン Shield Pokémon
0411 トリデプス Torideps - シールドポケモン Shield Pokémon
0412 ミノムッチ 
0413 ミノマダム 
0414 ガーメイル Gamale - ミノガポケモン 
0415 ミツハニー Mitsuhoney - はちのこポケモン 
0416 ビークイン 
0417 パチリス Pachirisu - でんきリスポケモン 
0418 ブイゼル Buoysel - うみイタチポケモン 
0419 フローゼル Floazel - うみイタチポケモン 
0420 チェリンボ 
0421 チェリム Cherrim - サクラポケモン 
0422 カラナクシ Karanakushi - ウミウシポケモン Sea Slug Pokémon
0423 トリトドン Tritodon - ウミウシポケモン Sea Slug Pokémon
0424 カラナクシ Eteboth - おながポケモン 
0425 フワンテ Fuwante - ふうせんポケモン Balloon Pokémon
0426 フワライド Fuwaride - ききゅうポケモン 
0427 ミミロル Mimiroll - うさぎポケモン Rabbit Pokémon
0428 ミミロップ Mimilop - うさぎポケモン Rabbit Pokémon
0429 ムウマージ Mumagi - マジカルポケモン Magical Pokémon
0430 ドンカラス Donkarasu - おおボスポケモン 
0431 ニャルマー Nyarmar - ねこかぶりポケモン 
0432 ブニャット Bunyat - とらねこポケモン 
0433 リーシャン Rishan - すずポケモン 
0434 スカンプー Skunpuu - スカンクポケモン 
0435 スカタンク Skutank - スカンクポケモン 
0436 ドーミラー 
0437 ドータクン Dotakun - どうたくポケモン 
0438 ウソハチ Usohachi - ぼんさいポケモン 
0439 マネネ Manene - マイムポケモン Mime Pokémon
0440 ピンプク Pinpuku - ままごとポケモン 
0441 ペラップ Perap - おんぷポケモン 
0442 ミカルゲ Mikaruge - ふういんポケモン Sealed Pokémon
0443 フカマル 
0444 ガバイト 
0445 ガブリアス Gaburias - マッハポケモン Mach Pokémon
0446 ゴンベ Gonbe - おおぐいポケモン 
0447 リオル Riolu - はもんポケモン Ripple Pokémon
0448 ルカリオ Lucario - はどうポケモン Guiding Waves Pokémon
0449 ヒポポタス 
0450 カバルドン 
0451 スコルピ Scorupi - さそりポケモン Scorpion Pokémon
0452 ドラピオン Drapion - ばけさそりポケモン Monster Scorpion Pokémon
0453 グレッグル Gureggru - どくづきポケモン Poison Jab Pokémon
0454 ドクロッグ Dokurog - どくづきポケモン Poison Jab Pokémon
0455 マスキッパ Muscippa - むしとりポケモン 
0456 ケイコウオ Keikouo - はねうおポケモン 
0457 ネオラント Neolant - ネオンポケモン Neon Pokémon
0458 タマンタ Tamanta - カイトポケモン Kite Pokémon
0459 ユキカブリ 
0460 ユキノオー Yukinooh - じゅひょうポケモン 
0461 マニューラ Manyula - かぎづめポケモン 
0462 ジバコイル Jibacoil - じばポケモン Magnetic Field Pokémon
0463 ベロベルト Berobelt - なめまわしポケモン Licking Pokémon
0464 ドサイドン Dosaidon - ドリルポケモン Drill Pokémon
0465 モジャンボ 
0466 エレキブル Elecible - らいでんポケモン Thunder and Lightning Pokémon
0467 ブーバーン Booburn - ばくえんポケモン 
0468 トゲキッス Togekiss - しゅくふくポケモン Jubilee Pokémon
0469 メガヤンマ Megayanma - オニトンボポケモン 
0470 リーフィア Leafia - しんりょくポケモン Fresh Verdure Pokémon
0471 グレイシア Glacia - しんせつポケモン Fresh Snow Pokémon
0472 グライオン 
0473 マンムー Mammoo - 2ほんキバポケモン 
0474 ポリゴンＺ 
0475 エルレイド Earlade - やいばポケモン Blade Pokémon
0476 ダイノーズ Dainose - コンパスポケモン Compass Pokémon
0477 ヨノワール Yonoir - てづかみポケモン Grasping Pokémon
0478 ユキメノコ Yukimenoko - ゆきぐにポケモン 
0479 ロトム Rotom - プラズマポケモン Plasma Pokémon
0480 ユクシー Uxie - ちしきポケモン Knowledge Pokémon
0481 エムリット M'rit - かんじょうポケモン Emotion Pokémon
0482 アグノム Agnome - いしポケモン Willpower Pokémon
0483 ディアルガ Dialga - じかんポケモン Time Pokémon
0484 パルキア Palkia - じかんポケモン Space Pokémon
0485 ヒードラン Heatran - かこうポケモン 
0486 レジギガス Regigigas - きょだいポケモン 
0487 ギラティナ 
0488 クレセリア Cresselia - みかづきポケモン Crescent Moon Pokémon
0489 フィオネ 
0490 マナフィ Manaphy - かいゆうポケモン Seafaring Pokémon
0491 ダークライ Darkrai - あんこくポケモン Pitch-Black Pokémon
0492 シェイミ Xiemi - かんしゃポケモン Gratitude Pokémon
0493 アルセウス Arceus - そうぞうポケモン Creation Pokémon
0494 ビクティニ Victini - しょうりポケモン 
0495 ツタージャ Tsutarja - くさへびポケモン Grass Snake Pokémon
0496 ジャノビー Janovy - くさへびポケモン Grass Snake Pokémon
0497 ジャローダ Jalorda - ロイヤルポケモン Royal Pokémon
0498 ポカブ Pokabu - ひぶたポケモン 
0499 チャオブー Chaoboo - ひぶたポケモン 
0500 エンブオー Enbuoh - おおひぶたポケモン 
0501 ミジュマル Mijumaru - ラッコポケモン 
0502 フタチマル Futachimaru - しゅぎょうポケモン 
0503 ダイケンキ Daikenki - かんろくポケモン 
0504 ミネズミ Minezumi - みはりポケモン Scout Pokémon
0505 ミルホッグ Miruhog - けいかいポケモン 
0506 ヨーテリー Yorterrie - こいぬポケモン Puppy Pokémon
0507 ハーデリア Herderrie - ちゅうけんポケモン 
0508 ムーランド Mooland - かんだいポケモン Big-Hearted Pokémon
0509 チョロネコ Choroneko - しょうわるポケモン Devious Pokémon
0510 レパルダス Leopardas - れいこくポケモン 
0511 ヤナップ Yanape - くさざるポケモン 
0512 ヤナッキー Yanakkie - とげざるポケモン 
0513 バオップ Baope - こうおんポケモン 
0514 バオッキー Baokkie - ひのこポケモン 
0515 ヒヤップ Hiyape - みずかけポケモン 
0516 ヒヤッキー Hiyakkie - ほうすいポケモン
0517 ムンナ Munna - ゆめくいポケモン 
0518 ムシャーナ Musharna - ゆめうつつポケモン 
0519 マメパト Mamepato - こばとポケモン 
0520 ハトーボー Hatoboh - のばとポケモン 
0521 ケンホロウ Kenhallow - プライドポケモン Pride Pokémon
0522 シママ Shimama - たいでんポケモン 
0523 ゼブライカ Zebraika - らいでんポケモン 
0524 ダンゴロ Dangoro - マントルポケモン Mantle Pokémon
0525 ガントル Gantle - こうせきポケモン Ore Pokémon
0526 ギガイアス Gigaiath - こうあつポケモン 
0527 コロモリ Koromori - こうもりポケモン 
0528 ココロモリ Kokoromori - きゅうあいポケモン 
0529 モグリュー Mogurew - もぐらポケモン Mole Pokémon
0530 ドリュウズ Doryuzu - ちていポケモン Subterrene Pokémon
0531 タブンネ Tabunne - ヒヤリングポケモン 
0532 ドッコラー Dokkorar - きんこつポケモン Muscular Pokémon
0533 ドテッコツ Dotekkotsu - きんこつポケモン Muscular Pokémon
0534 ローブシン Roubushin - きんこつポケモン Muscular Pokémon
0535 オタマロ 
0536 ガマガル Gamagaru - しんどうポケモン Vibration Pokémon
0537 ガマゲロゲ Gamageroge - しんどうポケモン Vibration Pokémon
0538 ナゲキ Nageki - じゅうどうポケモン Judo Pokémon
0539 ダゲキ Dageki - からてポケモン Karate Pokémon
0540 クルミル Kurumiru - さいほうポケモン 
0541 クルマユ Kurumayu - はごもりポケモン 
0542 ハハコモリ Hahakomori - こそだてポケモン Nurturing Pokémon
0543 フシデ Fushide - ムカデポケモン Centipede Pokémon
0544 ホイーガ Wheega - まゆムカデポケモン 
0545 ペンドラー Pendrar - メガムカデポケモン Mega Centipede Pokémon
0546 モンメン Monmen - わたたまポケモン 
0547 エルフーン Elfoon - かぜかくれポケモン 
0548 チュリネ Churine - ねっこポケモン 
0549 ドレディア Dredear - はなかざりポケモン Flowering Pokémon | Hisuian Form - スピンポケモン 
0550 バスラオ 
0551 メグロコ Meguroco - さばくワニポケモン Desert Croc Pokémon
0552 ワルビル Waruvile - さばくワニポケモン Desert Croc Pokémon
0553 ワルビアル Waruvial - いかくポケモン Intimidation Pokémon
0554 ダルマッカ Darumakka - だるまポケモン 
0555 ヒヒダルマ Hihidaruma - えんじょうポケモン Blazing Pokémon
0556 マラカッチ Maracacchi - サボテンポケモン 
0557 イシズマイ Ishizumai - いしやどポケモン 
0558 イワパレス Iwapalace - いわやどポケモン 
0559 ズルッグ Zuruggu - だっぴポケモン 
0560 ズルズキン 
0561 シンボラー Symboler - とりもどきポケモン 
0562 デスマス Deathmas - たましいポケモン Soul Pokémon
0563 デスカーン Deathkan - かんおけポケモン 
0564 プロトーガ Protoga - こだいがめポケモン 
0565 アバゴーラ Abagoura - こだいがめポケモン 
0566 アーケン Archen - さいこどりポケモン 
0567 アーケオス Archeos - さいこどりポケモン 
0568 ヤブクロン Yabukuron - ゴミぶくろポケモン 
0569 ダストダス Dustdas - ゴミすてばポケモン 
0570 ゾロア Zoroa - わるぎつねポケモン  - Hisuian Form - うらみぎつねポケモン 
0571 ゾロアーク Zoroark - ばけぎつねポケモン Transforming Fox - Hisuian Form - のろいぎつねポケモン 
0572 チラーミィ Chillarmy - チンチラポケモン Chinchilla Pokémon
0573 チラチーノ Chillaccino - スカーフポケモン Scarf Pokémon
0574 ゴチム Gothim - ぎょうしポケモン 
0575 ゴチミル Gothimiru - あやつりポケモン 
0576 ゴチルゼル Gothiruselle - てんたいポケモン 
0577 ユニラン Uniran - さいぼうポケモン 
0578 ダブラン Doublan - ぶんかつポケモン 
0579 ランクルス Lanculus - ぞうふくポケモン 
0580 コアルヒー Koaruhie - みずどりポケモン Water Bird Pokémon
0581 スワンナ Swanna - しらとりポケモン 
0582 バニプッチ Vanipetit - しんせつポケモン Fresh Snow Pokémon
0583 バニリッチ Vanirich - ひょうせつポケモン 
0584 バイバニラ 
0585 シキジカ Shikijika - きせつポケモン 
0586 メブキジカ Mebukijika - きせつポケモン 
0587 エモンガ Emonga - モモンガポケモン 
0588 カブルモ 
0589 シュバルゴ Chevargo - きへいポケモン 
0590 タマゲタケ Tamagetake - きのこポケモン Mushroom Pokémon
0591 モロバレル Morobareru - きのこポケモン Mushroom Pokémon
0592 プルリル Pururill - ふゆうポケモン 
0593 ブルンゲル 
0594 ママンボウ Mamanbou - かいほうポケモン Caring Pokémon
0595 バチュル Bachul - くっつきポケモン 
0596 デンチュラ Dentula - でんきグモポケモン 
0597 テッシード Tesseed - とげのみポケモン 
0598 ナットレイ Nutrey - とげだまポケモン Thorn Pod Pokémon
0599 ギアル Gear - はぐるまポケモン 
0600 ギギアル Gegear - はぐるまポケモン 
0601 ギギギアル Gegegear - はぐるまポケモン 
0602 シビシラス 
0603 シビビール 
0604 シビルドン Shibirudon - でんきうおポケモン 
0605 リグレー Ligray - ブレインポケモン Brain Pokémon
0606 オーベム Ohbem - ブレインポケモン Brain Pokémon
0607 ヒトモシ Hitomoshi - ろうそくポケモン Candle Pokémon
0608 ランプラー Lampler - ランプポケモン Lamp Pokémon
0609 シャンデラ 
0610 キバゴ Kibago - キバポケモン 
0611 オノンド 
0612 オノノクス Ononox - あごオノポケモン Axe Jaw Pokémon
0613 クマシュン Kumashun - ひょうけつポケモン Freezing Pokémon
0614 ツンベアー Tunbear - とうけつポケモン Frozen Pokémon
0615 フリージオ 
0616 チョボマキ Chobomaki - マイマイポケモン 
0617 アギルダー Agilder - からぬけポケモン 
0618 マッギョ Maggyo - トラップポケモン Trap Pokémon
0619 コジョフー 
0620 コジョンド Kojondo - ぶじゅつポケモン Martial Arts Pokémon
0621 クリムガン Crimgan - ほらあなポケモン Cave Pokémon
0622 ゴビット 
0623 ゴルーグ Golugh - ゴーレムポケモン Golem Pokémon
0624 コマタナ 
0625 キリキザン Kirikizan - とうじんポケモン  
0626 バッフロン Buffron - ずつきうしポケモン 
0627 ワシボン Washibon - ヒナわしポケモン 
0628 ウォーグル Warrgle - ゆうもうポケモン Valiant Pokémon | Hisuian Form - おたけびポケモン 
0629 バルチャイ Vulchi - おむつポケモン 
0630 バルジーナ Vulgina - ほねわしポケモン 
0631 クイタラン Kuitaran - アリクイポケモン Anteater Pokémon
0632 アイアント Iront - てつアリポケモン Iron Ant Pokémon
0633 モノズ Monozu - そぼうポケモン 
0634 ジヘッド Dihead - らんぼうポケモン Hostile Pokémon
0635 サザンドラ Sazandra - きょうぼうポケモン Brutal Pokémon
0636 メラルバ Melarva - たいまつポケモン 
0637 ウルガモス Ulgamoth - たいようポケモン Sun Pokémon
0638 コバルオン Cobalion - てっしんポケモン 
0639 テラキオン Terrakion - がんくつポケモン 
0640 ビリジオン Viridion - そうげんポケモン Grassland Pokémon
0641 トルネロス Tornelos - せんぷうポケモン 
0642 ボルトロス Voltolos - らいげきポケモン 
0643 レシラム Reshiram - はくようポケモン 
0644 ゼクロム Zekrom - こくいんポケモン 
0645 ランドロス 
0646 キュレム Kyurem - きょうかいポケモン 
0647 ケルディオ 
0648 メロエッタ Meloetta - せんりつポケモン 
0649 ゲノセクト Genosect - こせいだいポケモン 
0650 ハリマロン Harimarron - いがぐりポケモン 
0651 ハリボーグ Haribogue - とげよろいポケモン Spiny Armor Pokémon
0652 ブリガロン Brigarron - とげよろいポケモン Spiny Armor Pokémon
0653 フォッコ 
0654 テールナー Tairenar - キツネポケモン Fox Pokémon
0655 マフォクシー Mafoxy - キツネポケモン Fox Pokémon
0656 ケロマツ Keromatsu - あわがえるポケモン Bubble Frog Pokémon
0657 ゲコガシラ Gekogashira - あわがえるポケモン Bubble Frog Pokémon
0658 ゲッコウガ Gekkouga - しのびポケモン Shinobi Pokémon
0659 ホルビー Horubee - あなほりポケモン 
0660 ホルード Horudo - あなほりポケモン 
0661 ヤヤコマ Yayakoma - コマドリポケモン 
0662 ヒノヤコマ 
0663 ファイアロー Fiarrow - れっかポケモン 
0664 コフキムシ Kofukimushi - こなふきポケモン 
0665 コフーライ 
0666 ビビヨン 
0667 シシコ 
0668 カエンジシ 
0669 フラベベ Flabébé - いちりんポケモン Single Bloom Pokémon
0670 フラエッテ Floette - いちりんポケモン Single Bloom Pokémon
0671 フラージェス Florges - ガーデンポケモン Garden Pokémon
0672 メェークル 
0673 ゴーゴート 
0674 ヤンチャム Yancham - やんちゃポケモン 
0675 ゴロンダ Goronda - こわもてポケモン 
0676 トリミアン Trimmien - プードルポケモン Poodle Pokémon
0677 ニャスパー 
0678 ニャオニクス Nyaonyx - よくせいポケモン Constraint Pokémon
0679 ヒトツキ 
0680 ニダンギル 
0681 ギルガルド Gilgard - おうけんポケモン Royal Sword Pokémon
0682 シュシュプ 
0683 フレフワン 
0684 ペロッパフ Peropuff - わたあめポケモン Cotton Candy Pokémon
0685 ペロリーム Peroream - ホイップポケモン 
0686 マーイーカ Maaiika - かいてんポケモン 
0687 カラマネロ Calamanero - ぎゃくてんポケモン Turnaround Pokémon
0688 カメテテ Kametete - ふたてポケモン Two-Handed Pokémon
0689 ガメノデス 
0690 クズモー 
0691 ドラミドロ 
0692 ウデッポウ Udeppou - みずでっぽうポケモン Water Gun Pokémon
0693 ブロスター Bloster - ランチャーポケモン Launcher Pokémon
0694 エリキテル 
0695 エレザード Elezard - はつでんポケモン 
0696 チゴラス 
0697 ガチゴラス Gachigoras - ぼうくんポケモン 
0698 アマルス 
0699 アマルルガ Amaruruga - ツンドラポケモン Tundra Pokémon
0700 アマルルガ Nymphia - むすびつきポケモン Intertwining Pokémon
0701 ルチャブル Luchabull - レスリングポケモン Wrestling Pokémon
0702 デデンネ Dedenne - アンテナポケモン Antenna Pokémon
0703 メレシー Melecie - ほうせきポケモン 
0704 ヌメラ Numera - なんたいポケモン 
0705 ヌメイル 
0706 ヌメルゴン Numelgon - ドラゴンポケモン Dragon Pokémon
0707 クレッフィ Cleffy - かぎたばポケモン Key Ring Pokémon
0708 ボクレー 
0709 オーロット Ohrot - ろうぼくポケモン Elder Tree Pokémon
0710 バケッチャ 
0711 パンプジン Pumpjin - かぼちゃポケモン Pumpkin Pokémon
0712 カチコール Kachikooru - ひょうかいポケモン Ice Chunk Pokémon
0713 クレベース Crebase - ひょうざんポケモン 
0714 オンバット 
0715 オンバーン Onvern - おんぱポケモン Sound Wave Pokémon
0716 ゼルネアス Xerneas - せいめいポケモン 
0717 イベルタル Yveltal - はかいポケモン 
0718 ジガルデ Zygarde - ちつじょポケモン - Order Pokémon
0719 ディアンシー Diancie - ほうせきポケモン 
0720 フーパ 
0721 ボルケニオン 
0722 モクロー Mokuroh - くさばねポケモン Grass Quill Pokémon
0723 フクスロー Fukuthrow - はばねポケモン Blade Quill Pokémon
0724 ジュナイパー Ju'niper - やばねポケモン Arrow Quill Pokémon
0725 ニャビー Nyabby - ひねこポケモン Fire Cat Pokémon
0726 ニャヒート Nyaheat - ひねこポケモン Fire Cat Pokémon
0727 ガオガエン Gaogaen - ヒールポケモン Heel Pokémon
0728 アシマリ Ashimari - あしかポケモン Sea Lion Pokémon
0729 オシャマリ Oshamari - アイドルポケモン Idol Pokémon
0730 アシレーヌ Ashirène - ソリストポケモン Soloist Pokémon
0731 ツツケラ Tsutsukera - きつつきポケモン Woodpecker Pokémon
0732 ケララッパ Kerarappa - ラッパぐちポケモン Bugle Beak Pokémon
0733 ドデカバシ Dodekabashi - おおづつポケモン Cannon Pokémon
0734 ヤングース Youngoose - うろつきポケモン Prowling Pokémon
0735 デカグース Dekagoose - はりこみポケモン Stakeout Pokémon
0736 アゴジムシ Agojimushi - ようちゅうポケモン Larva Pokémon
0737 デンヂムシ Denjimushi - バッテリーポケモン Battery Pokémon
0738 クワガノン Kuwagannon - くわがたポケモン Stag Beetle Pokémon
0739 マケンカニ Makenkani - けんとうポケモン Boxing Pokémon
0740 ケケンカニ Kekenkani - けがにポケモン Horsehair Crab Pokémon
0741 オドリドリ Odoridori - ダンスポケモン Dancing Pokémon
0742 アブリー Abuly - ツリアブポケモン Bee Fly Pokémon
0743 アブリボン Aburibbon - ツリアブポケモン Bee Fly Pokémon
0744 イワンコ Iwanko - こいぬポケモン Puppy Pokémon
0745 ルガルガン Lugarugan - オオカミポケモン Wolf Pokémon
0746 ヨワシ Yowashi - こざかなポケモン Small Fry Pokémon
0747 ヒドイデ Hidoide - ヒトデナシポケモン Brutal Star Pokémon
0748 ドヒドイデ Dohidoide - ヒトデナシポケモン Brutal Star Pokémon
0749 ドロバンコ Dorobanko - うさぎうまポケモン Donkey Pokémon
0750 バンバドロ Banbadoro - ばんばポケモン Draft Horse Pokémon
0751 シズクモ Shizukumo - すいほうポケモン Water Bubble Pokémon
0752 オニシズクモ Onishizukumo - すいほうポケモン Water Bubble Pokémon
0753 カリキリ Karikiri - かまくさポケモン Sickle Grass Pokémon
0754 ラランテス Larantes - はなかまポケモン Flower Sickle Pokémon
0755 ネマシュ Nemush - はっこうポケモン Illuminating Pokémon
0756 マシェード Mushade - はっこうポケモン Illuminating Pokémon
0757 ヤトウモリ Yatoumori - どくトカゲポケモン Poison Lizard Pokémon
0758 エンニュート Ennewt - どくトカゲポケモン Poison Lizard Pokémon
0759 ヌイコグマ Nuikoguma - じたばたポケモン Flailing Pokémon
0760 キテルグマ Kiteruguma - ごうわんポケモン Strong Arm Pokémon
0761 アマカジ Amakaji - フルーツポケモン Fruit Pokémon
0762 アママイコ Amamaiko - フルーツポケモン Fruit Pokémon
0763 アマージョ Amajo - フルーツポケモン Fruit Pokémon
0764 キュワワー Cuwawa - はなつみポケモン Flower Picker Pokémon
0765 ヤレユータン Yareyutan - けんじゃポケモン Sage Pokémon
0766 ナゲツケサル Nagetsukesaru - れんけいポケモン Teamwork Pokémon
0767 コソクムシ Kosokumushi - そうこうポケモン Hightail Pokémon
0768 グソクムシャ Gusokumusha - そうこうポケモン Platemail Pokémon
0769 スナバァ Sunaba - すなやまポケモン Sand Heap Pokémon
0770 シロデスナ Shirodeathna - すなのしろポケモン Sand Castle Pokémon
0771 ナマコブシ Namakobushi - なまこポケモン Sea Cucumber Pokémon
0772 タイプ：ヌル Type: Null - じんこうポケモン 
0773 シルヴァディ Silvuddy - じんこうポケモン 
0774 メテノ Meteno - ながれぼしポケモン Meteor Pokémon
0775 ネッコアラ Nekkoala - ゆめうつつポケモン Drowsing Pokémon
0776 バクガメス Bakugames - ばくはつがめポケモン 
0777 トゲデマル Togedemaru - まるまりポケモン Roly-Poly Pokémon
0778 ミミッキュ Mimikkyu - ばけのかわポケモン Disguise Pokémon
0779 ハギギシリ Hagigishiri - はぎしりポケモン Bruxism Pokémon
0780 ジジーロン Jijilong - ゆうゆうポケモン Placid Pokémon
0781 ダダリン Dadarin - もくずポケモン Sea Scrap Pokémon
0782 ジャラコ Jarako - うろこポケモン 
0783 ジャランゴ Jarango - うろこポケモン 
0784 ジャラランガ Jararanga - うろこポケモン 
0785 カプ・コケコ Kapu-Kokeko - とちがみポケモン Land God Pokémon
0786 カプ・テテフ Kapu-Tetefu - とちがみポケモン Land God Pokémon
0787 カプ・ブルル Kapu-Bulul - とちがみポケモン Land God Pokémon
0788 カプ・レヒレ Kapu-Rehire - とちがみポケモン Land God Pokémon
0789 コスモッグ Cosmog - せいうんポケモン 
0790 コスモウム Cosmovum - げんしせいポケモン 
0791 ソルガレオ Solgaleo - にちりんポケモン Sunne Pokémon
0792 ルナアーラ Lunala - がちりんポケモン Moone Pokémon
0793 ウツロイド Utsuroid - きせいポケモン 
0794 マッシブーン Massivoon - ぼうちょうポケモン Swollen Pokémon
0795 フェローチェ Pheroache - えんびポケモン Sensual Pokémon
0796 デンジュモク Denjumoku - でんしょくポケモン Glowing Pokémon
0797 テッカグヤ Tekkaguya - うちあげポケモン Launch Pokémon
0798 カミツルギ Kamitsurugi - ばっとうポケモン Drawn Sword Pokémon
0799 アクジキング Akujiking - あくじきポケモン Junkivore Pokémon
0800 ネクロズマ Necrozma - プリズムポケモン Prism Pokémon
0801 マギアナ Magearna - じんぞうポケモン Artificial Pokémon
0802 マーシャドー Marshadow - かげすみポケモン 
0803 ベベノム Bebenom - どくばりポケモン Poison Needle Pokémon
0804 アーゴヨン Agoyon - どくばりポケモン Poison Needle Pokémon
0805 ツンデツンデ Tsundetsunde - いしがきポケモン Stone Wall Pokémon
0806 ズガドーン Zugadon - はなびポケモン Fireworks Pokémon
0807 ゼラオラ Zeraora - じんらいポケモン 
0808 メルタン Meltan - ナットポケモン Hex Nut Pokémon
0809 メルメタル Melmetal - ナットポケモン Hex Nut Pokémon
0810 サルノリ Sarunori - こざるポケモン Chimp Pokémon
0811 バチンキー Bachinkey - ビートポケモン Beat Pokémon
0812 ゴリランダー Gorillander - ドラマーポケモン Drummer Pokémon
0813 ヒバニー Hibunny - うさぎポケモン Rabbit Pokémon
0814 ラビフット Rabbifoot - うさぎポケモン Rabbit Pokémon
0815 エースバーン Aceburn - ストライカーポケモン Striker Pokémon
0816 メッソン Messon - みずとかげポケモン Water Lizard Pokémon
0817 ジメレオン Jimeleon - みずとかげポケモン Water Lizard Pokémon
0818 インテレオン Inteleon - エージェントポケモン Agent Pokémon
0819 ホシガリス Hoshigarisu - ほおばりポケモン Cheek-Stuffing Pokémon
0820 ヨクバリス Yokubarisu - よくばりポケモン Greedy Pokémon
0821 ココガラ Kokogara - ことりポケモン Tiny Bird Pokémon
0822 アオガラス Aogarasu - カラスポケモン Raven Pokémon
0823 アーマーガア Armorgaw - カラスポケモン Raven Pokémon
0824 サッチムシ 
0825 レドームシ 
0826 イオルブ 
0827 クスネ Kusune - きつねポケモン Fox Pokémon
0828 フォクスライ Foxly - きつねポケモン Fox Pokémon
0829 ヒメンカ Himenka - はなかざりポケモン Flowering Pokémon
0830 ワタシラガ Watashiraga - わたかざりポケモン 
0831 ウールー Wooloo - ひつじポケモン Sheep Pokémon
0832 バイウールー Baiwooloo - ひつじポケモン Sheep Pokémon
0833 カムカメ Kamukame - くいつきポケモン Snapping Pokémon
0834 カジリガメ Kajirigame - かみつきポケモン Bite Pokémon
0835 ワンパチ Wanpachi - こいぬポケモン Puppy Pokémon
0836 パルスワン 
0837 タンドン Tandon - せきたんポケモン Coal Pokémon
0838 トロッゴン Toroggon - せきたんポケモン Coal Pokémon
0839 セキタンザン Sekitanzan - せきたんポケモン Coal Pokémon
0840 カジッチュ 
0841 アップリュー Appryuu - りんごはねポケモン 
0842 タルップル Tarpple - りんごじるポケモン Apple Juice Pokémon
0843 スナヘビ Sunahebi - すなへびポケモン Sand Snake Pokémon
0844 サダイジャ Sadaija - すなへびポケモン Sand Snake Pokémon
0845 ウッウ U'u - うのみポケモン Gulp Pokémon
0846 サシカマス Sashikamasu - とつげきポケモン Rush Pokémon
0847 カマスジョー Kamasujaw - くしざしポケモン 
0848 エレズン 
0849 ストリンダー Strinder - パンクポケモン Punk Pokémon
0850 ヤクデ 
0851 マルヤクデ Maruyakude - はつねつポケモン Radiator Pokémon
0852 タタッコ 
0853 オトスパス Otosupus - じゅうじゅつポケモン Jujitsu Pokémon
0854 ヤバチャ Yabacha - こうちゃポケモン Black Tea Pokémon
0855 ポットデス Potdeath - こうちゃポケモン Black Tea Pokémon
0856 ミブリム Mibrim - おだやかポケモン Calm Pokémon
0857 テブリム Tebrim - せいしゅくポケモン Silencing Pokémon
0858 ブリムオン Brimuon - せいじゃくポケモン Silent Pokémon
0859 ベロバー Beroba - いじわるポケモン Mean Pokémon
0860 ギモー Gimoh - しょうわるポケモン Devious Pokémon
0861 オーロンゲ Olonge - ビルドアップポケモン Buildup Pokémon
0862 タチフサグマ Tachifusaguma - ていしポケモン 
0863 ニャイキング Nyaiking - バイキングポケモン Viking Pokémon
0864 サニゴーン 
0865 ネギガナイト Negigaknight - かるがもポケモン Spot-Billed Duck Pokémon
0866 バリコオル Barrikohru - コメディアンポケモン Comedian Pokémon
0867 デスバーン Deathban - おんねんポケモン 
0868 マホミル Mahomil - クリームポケモン Cream Pokémon
0869 マホイップ Mawhip - クリームポケモン Cream Pokémon
0870 タイレーツ Tairetsu - じんけいポケモン Formation Pokémon
0871 バチンウニ Bachin'uni - うにポケモン 
0872 ユキハミ Yukihami - いもむしポケモン Caterpillar Pokémon
0873 モスノウ Mosnow - こおりがポケモン 
0874 イシヘンジン Ishihengin - きょせきポケモン Big Rock Pokémon
0875 コオリッポ Koorippo - ペンギンポケモン Penguin Pokémon
0876 イエッサン Yessan - かんじょうポケモン Emotion Pokémon
0877 モルペコ Morpeko - にめんポケモン Two-Sided Pokémon
0878 ゾウドウ 
0879 ダイオウドウ Daioudou - どうぞうポケモン 
0880 パッチラゴン Pacchiragon - かせきポケモン Fossil Pokémon
0881 パッチルドン Pacchilldon - かせきポケモン Fossil Pokémon
0882 ウオノラゴン Uonoragon - かせきポケモン Fossil Pokémon
0883 ウオチルドン Uochilldon - かせきポケモン Fossil Pokémon
0884 ジュラルドン Duraludon - ごうきんポケモン Alloy Pokémon
0885 ドラメシヤ Drameshiya - うらめしポケモン 
0886 ドロンチ Draunch - せわやくポケモン Caretaker Pokémon
0887 ドラパルト Drapult - ステルスポケモン 
0888 ザシアン Zacian - つわものポケモン 
0889 ザマゼンタ Zamazenta - つわものポケモン 
0890 ムゲンダイナ Mugendaina - キョダイポケモン 
0891 ダクマ Dakuma - けんぽうポケモン Single Strike Pokémon
0892 ウーラオス Wulaosu - けんぽうポケモン Single Strike Pokémon
0893 ザルード Zarude - わるざるポケモン 
0894 レジエレキ Regieleki - エレクトロンポケモン 
0895 レジドラゴ Regidrago - りゅうぎょくポケモン 
0896 ブリザポス 
0897 レイスポス 
0898 バドレックス 
0899 アヤシシ 
0900 バサギリ Basagiri - まさかりポケモン Battle-Axe Pokémon
0901 ガチグマ 
0902 イダイトウ 
0903 オオニューラ 
0904 ハリーマン 
0905 ラブトロス 
0906 ニャオハ Nyahoja - くさねこポケモン Grass Cat Pokémon
0907 ニャローテ Nyarote - くさねこポケモン Grass Cat Pokémon
0908 マスカーニャ Masquernya - マジシャンポケモン Magician Pokémon
0909 ホゲータ Hogator - ほのおワニポケモン Fire Croc Pokémon
0910 アチゲータ 
0911 ラウドボーン 
0912 クワッス Kuwassu - こがもポケモン Duckling Pokémon
0913 ウェルカモ Welcamo - レッスンポケモン 
0914 ウェーニバル
0915 グルトン Gourton - ぶたポケモン Pig Pokémon
0916 パフュートン Perfuton - ぶたポケモン Pig Pokémon
0917 タマンチュラ Tamantula - いとだまポケモン 
0918 ワナイダー Wanaider - トラップポケモン Trap Pokémon
0919 マメバッタ 
0920 エクスレッグ Exleg - バッタポケモン 
0921 パモ Pamo - ねずみポケモン Mouse Pokémon
0922 パモット Pamot - ねずみポケモン Mouse Pokémon
0923 パーモット Parmot -  - てあてポケモン 
0924 ワッカネズミ Wakkanezumi - カップルポケモン Couple Pokémon
0925 イッカネズミ Ikkanezumi - ファミリーポケモン Family Pokémon
0926 パピモッチ Puppymocchi - こいぬポケモン Puppy Pokémon
0927 バウッツェル
0928 ミニーブ Minive - オリーブポケモン Olive Pokémon
0929 オリーニョ Oliño - オリーブポケモン Olive Pokémon
0930 オリーヴァ Oliva - オリーブポケモン Olive Pokémon
0931 イキリンコ Ikirinko - インコポケモン Parrot Pokémon
0932 コジオ Kojio - がんえんポケモン Rock Salt Pokémon
0933 ジオヅム 
0934 キョジオーン Kyojiohn - がんえんポケモン Rock Salt Pokémon
0935 カルボウ Carbou - ひのこポケモン 
0936 グレンアルマ Guren'arma - ひのせんしポケモン 
0937 ソウブレイズ Soublades - ひのけんしポケモン Fire Swordsman Pokémon
0938 ズピカ 
0939 ハラバリー Harabari - でんきがえるポケモン Electric Frog Pokémon
0940 カイデン Kaiden - うみつばめポケモン Storm Petrel Pokémon
0941 タイカイデン Taikaiden - ぐんかんどりポケモン Frigatebird Pokémon
0942 オラチフ Orachiff - わかぞうポケモン 
0943 マフィティフ 
0944 シルシュルー 
0945 タギングル 
0946 アノクサ Anokusa - ころがりぐさポケモン Tumbleweed Pokémon
0947 アノホラグサ Anohoragusa - ころがりぐさポケモン Tumbleweed Pokémon
0948 ノノクラゲ Nonokurage - きくらげポケモン Wood Ear Pokémon
0949 リククラゲ Rikukurage - きくらげポケモン Wood Ear Pokémon
0950 ガケガニ Gakegani - まちぶせポケモン 
0951 カプサイジ Capsaiji - ハバネロポケモン Habanero Pokémon
0952 スコヴィラン 
0953 シガロコ 
0954 ベラカス 
0955 ヒラヒナ 
0956 クエスパトラ Cuespatra - ダチョウポケモン 
0957 カヌチャン Kanuchan - かなうちポケモン Metalsmith Pokémon
0958 ナカヌチャン Nakanuchan - ハンマーポケモン Hammer Pokémon
0959 デカヌチャン Dekanuchan - ハンマーポケモン Hammer Pokémon
0960 ウミディグダ Umidigda - あなごポケモン Garden Eel Pokémon
0961 ウミトリオ Umitrio - あなごポケモン Garden Eel Pokémon
0962 オトシドリ Otoshidori - おとしものポケモン Item-Dropping Pokémon
0963 ナミイルカ Namiiruka - イルカポケモン Dolphin Pokémon
0964 イルカマン Irukaman - イルカポケモン Dolphin Pokémon | Mighty Forme - ヒーローポケモン Hero Pokémon
0965 ブロロン Burorom - たんきとうポケモン Single-Cylinder Pokémon
0966 ブロロローム Burororoom - たきとうポケモン Multi-Cylinder Pokémon
0967 モトトカゲ Mototokage - ライドポケモン Ride Pokémon
0968 ミミズズ Mimizuzu - ミミズポケモン Earthworm Pokémon
0969 キラーメ Kirame - こうせきポケモン Ore Pokémon
0970 キラフロル Kiraflor - こうせきポケモン Ore Pokémon
0971 ボチ Bochi - おばけいぬポケモン Ghost Dog Pokémon
0972 ハカドッグ Hakadog - おばけいぬポケモン Ghost Dog Pokémon
0973 カラミンゴ 
0974 アルクジラ Arukujira - りくくじらポケモン Land Whale Pokémon
0975 ハルクジラ Hulkujira - りくくじらポケモン Land Whale Pokémon
0976 ミガルーサ 
0977 ヘイラッシャ 
0978 シャリタツ Sharitatsu - ぎたいポケモン Mimicry Pokémon
0979 コノヨザル Konoyozaru - ふんどざるポケモン Rage Monkey Pokémon
0980 ドオー Do'oh - とげうおポケモン Spiky Fish Pokémon
0981 リキキリン Rikikirin - くびながポケモン Long Neck Pokémon
0982 ノココッチ Nokokotchi - つちへびポケモン Land Snake Pokémon
0983 ドドゲザン Dodogezan - だいとうポケモン Glaive Pokémon
0984 イダイナキバ Mighty Tusks - パラドックスポケモン Paradox Pokémon
0985 サケブシッポ Screaming Tail - パラドックスポケモン Paradox Pokémon
0986 アラブルタケ 
0987 ハバタクカミ 
0988 チヲハウハネ 
0989 スナノケガワ 
0990 テツノワダチ 
0991 テツノツツミ 
0992 テツノカイナ 
0993 テツノコウベ 
0994 テツノドクガ 
0995 テツノイバラ 
0996 セビエ Sebie - こおりビレポケモン Ice Fin Pokémon
0997 セゴール 
0998 セグレイブ Seglaive - ひょうりゅうポケモン Ice Dragon Pokémon
0999 コレクレー Collecurei - たからばこポケモン  | Walking Forme - たからさがしポケモン Treasure Hunter Pokémon
1000 サーフゴー 
1001 チオンジェン 
1002 パオジアン 
1003 ディンルー 
1004 イーユイ 
1005 トドロクツキ 
1006 テツノブジン 
1007 コライドン Koraidon - パラドックスポケモン Paradox Pokémon
1008 ミライドン Miraidon - パラドックスポケモン Paradox Pokémon
1009 ウネルミナモ 
1010 テツノイサハ 
1011 カミッチュ 
1012 チャデス 
1013 ヤバソチャ Yabasocha - まっちゃポケモン 
1014 イイネイヌ 
1015 マシマシラ 
1016 キチキギス 
1017 オーガポン 
1018 ブリジュラス 
1019 カミツオロチ 
1020 ウガツホムラ Gouging Inferno - パラドックスポケモン Paradox Pokémon
1021 タケルライコ 
1022 テツノイワオ 
1023 テツノカシラ 
1024 テラパゴス Terapagos - テラスタルポケモン Terastal Pokémon
1025 モモワロウ 



FORMS

rotomu zukan ロトム図鑑 (Rotomdex) - Index Rotom
sumaho rotomu スマホロトム (Rotom Phone) - Smartphone Rotom
hiito rotomu ヒートロトム (Heat Rotom) - Heat Rotom
wosshu rotomu ウォッシュロトム (Wash Rotom) - Wash Rotom
furosuto rotomu フロストロトム (Frost Rotom) - Frost Rotom
supin rotomu スピンロトム (Fan Rotom) - Spin Rotom
katto rotomu カットロトム (Mow Rotom) - Cut Rotom



GENDERS

Satoshi's Pikachu - Male (gender design difference)
Satoshi's Heigani - Male (referred to as "otoko" in MPM)
Satoshi's Kairyu - Female (game distribution)
Satoshi's Gänger - Male (game distribution)
Satoshi's Lucario - Male (game distribution)
Satoshi's Negigaknight - Male (referred to as "kare" by Citron in PM19)

Kasumi's Udeppou - Male (referred to as "otoko" in MPM)

Iris's Ononox - Male (referred to as "onii-chan" by Iris in BW)
Iris's Doryuzu - Male (attracted to female Emonga in BW)
Iris's Emonga - Female

Shirona's Gaburias - Female (gender design difference)

Go's Aceburn - Male (referred to as "aniki" by Yasuda in behind the scenes material)
Go's Inteleon - Male (Yabashi's Kakuleon falls for him in PM19)

Sakuragi's Wanpachi - Male (referred to as "onii-chan" by Koharu in PM19)

Liko's Nyarote - Female (attracted to male Perfuton in PM23)
Liko's Mibrim - Female (monogender species)

Roy's Hogator - Male (not attracted to male Perfuton in PM23)

Dot's Kuwassu - Male (attracted female Pokémon in PM23)

Friede's Pikachu - Male (gender design difference)

Murdock's Mawhip - Female (monogender species)

Gibeon's Zygarde - Male (referred to as "kare" by Lucius in PM23 087)



LOCATIONS

kantou chihou カントー地方 (Kanto region) - Kanto Region
jouto chihou ジョウト地方 (Johto region) - Johto Region
houen chihou ホウエン地方 (Hoenn region) - Hoenn Region
shin'ou chihou シンオウ地方 (Sinnoh region) - Sinnoh Region
isshu chihou イッシュ地方 (Unova region) - Isshu Region
karosu chihou カロス地方 (Kalos region) - Kalos Region
arora chihou アローラ地方 (Alola region) - Alola Region
gararu chihou ガラル地方 (Galar region) - Galar Region
hisui chihou ヒスイ地方 (Hisui region) - Hisui Region
parudea chihou パルデア地方 (Paldea region) - Paldea Region
masara taun マサラタウン (Pallet Town) - Masara Town
tokiwa shiti トキワシティ (Viridian Ciy) - Tokiwa City
nibi shiti ニビシティ (Pewter City) - Nibi City
hanada shiti ハナダシティ (Cerulean City) - Hanada City
kuchiba shiti クチバシティ (Vermillion City) - Kuchiba City
futagojima 双子島 (Seafoam Islands) - Twins Island
tenganzan テンガン山 (Mount Coronet) - Mt. Tengan
nappe yama ナッペ山 (Glaseado Mountain) - Mt. Nappé



MISC

monsutaa booru モンスターボール (Poké Ball) - Monster Ball
pokemon zukan ポケモン図鑑 (Pokédex) - Pokémon Index
sugata すがた (Form) - Form
forumu フォルム (Forme) - Forme
roketto-dan ロケット団 (Team Rocket) - Team Rocket
aku taipu あくタイプ (Dark type) - Evil type
hadou 波導 (Aura) - Guiding Waves
tou-chan とうちゃん (Dada) - Dada

ゲーチス G-Cis
マーマネ Māmane
ハプウ Hāpu'u

Classic Team Rocket motto:
Musashi: If you ask us about “this” or “that”...
Kojiro: We’ll answer out of \N sympathy for the world!
Musashi: To protect the world from devastation.
Kojiro: To preserve world peace.
Musashi: Championing the evils \N of truth and love.
Kojiro: We’re the lovely, charming villains.
Musashi: Musashi!
Kojiro: Kojiro!
Musashi: The Team Rocket duo \N soars through the galaxy!
Kojiro: Like a white hole, \N a white tomorrow awaits us!
Nyarth: Just kidding, meow!



STYLISTIC GUIDELINES FOR OUR PROJECTS

"Type" is only hyphenated if it's followed by a noun. So, "Pikachu is an Electric type. His Lightning Speed is a Normal-type move. This move is not very effective against Rock-type Pokémon."
The word "region" is lower-case when used on its own, upper-case when following the region name (example: Alola Region).
Use commas when writing out numbers with four or more digits (example: 100,000 Volts).
Words like "sir" and "ma'am" should be lower-case unless they're part of a title or part of the address at the start of a letter.
Family names should be upper-case when addressing a specific person ("Hi, Gramps!").
"Mythical Pokémon" is used as a translation of maboroshi no pokemon for generation 4 content onwards, save for Mewtwo Strikes Back Evolution. For generations 1 and 2, "Phantom Pokémon" is used. Either is usable for generation 3.
Moves and ability names are upper-case, but the words "move" and "ability" should be lower-case.
Stats and natures should be lower-case.
"Goodbye," not "Good bye."
"All right," not "Alright."
Exclamation and question marks only go inside quotation marks when the quotated word or phrase is an exclamation or a question, respectively.
Periods and commas go inside quotation marks unless there's an exclamation or question mark already, in which case they go outside if they can't be omitted.
All punctuation directly following or preceding italicized words is to be italicized.
Outside of edge cases, italics are only used for emphasis, to help convey inflection, and/or to denote when a line is being delivered by three or more characters.
Always use spoken name order (example: Okido Yukinari, Nariya Okido).
